Word	Category
Dancing	Charades - Actions
Swimming	Charades - Actions
Cooking	Charades - Actions
Driving	Charades - Actions
Fishing	Charades - Actions
Skiing	Charades - Actions
Typing	Charades - Actions
Painting	Charades - Actions
Singing	Charades - Actions
Sleeping	Charades - Actions
Running	Charades - Actions
Jumping	Charades - Actions
Eating	Charades - Actions
Drinking	Charades - Actions
Reading	Charades - Actions
Writing	Charades - Actions
Cleaning	Charades - Actions
Shopping	Charades - Actions
Crying	Charades - Actions
Laughing	Charades - Actions
Sneezing	Charades - Actions
Yawning	Charades - Actions
Stretching	Charades - Actions
Whistling	Charades - Actions
Clapping	Charades - Actions
Waving	Charades - Actions
Hugging	Charades - Actions
Kissing	Charades - Actions
Shaking Hands	Charades - Actions
High-Fiving	Charades - Actions
Climbing	Charades - Actions
Crawling	Charades - Actions
Skipping	Charades - Actions
Hopping	Charades - Actions
Tiptoeing	Charades - Actions
Surfing	Charades - Actions
Skateboarding	Charades - Actions
Bowling	Charades - Actions
Golfing	Charades - Actions
Boxing	Charades - Actions
Wrestling	Charades - Actions
Juggling	Charades - Actions
Magic Trick	Charades - Actions
Blowing Bubbles	Charades - Actions
Flying a Kite	Charades - Actions
Riding a Bike	Charades - Actions
Rowing a Boat	Charades - Actions
Paddling a Canoe	Charades - Actions
Ice Skating	Charades - Actions
Roller Skating	Charades - Actions
Snowboarding	Charades - Actions
Rock Climbing	Charades - Actions
Bungee Jumping	Charades - Actions
Parachuting	Charades - Actions
Scuba Diving	Charades - Actions
Snorkeling	Charades - Actions
Horseback Riding	Charades - Actions
Weightlifting	Charades - Actions
Doing Yoga	Charades - Actions
Meditating	Charades - Actions
Taking a Selfie	Charades - Actions
Texting	Charades - Actions
Video Calling	Charades - Actions
Playing Video Games	Charades - Actions
Knitting	Charades - Actions
Sewing	Charades - Actions
Ironing	Charades - Actions
Vacuuming	Charades - Actions
Mopping	Charades - Actions
Gardening	Charades - Actions
Planting Flowers	Charades - Actions
Mowing the Lawn	Charades - Actions
Raking Leaves	Charades - Actions
Shoveling Snow	Charades - Actions
Washing Dishes	Charades - Actions
Brushing Teeth	Charades - Actions
Combing Hair	Charades - Actions
Shaving	Charades - Actions
Putting on Makeup	Charades - Actions
Tying Shoes	Charades - Actions
Pizza	Charades - Food & Snacks
Spaghetti	Charades - Food & Snacks
Hamburger	Charades - Food & Snacks
Hot Dog	Charades - Food & Snacks
Taco	Charades - Food & Snacks
Burrito	Charades - Food & Snacks
Nachos	Charades - Food & Snacks
French Fries	Charades - Food & Snacks
Chicken Nuggets	Charades - Food & Snacks
Popcorn	Charades - Food & Snacks
Ice Cream Cone	Charades - Food & Snacks
Popsicle	Charades - Food & Snacks
Lollipop	Charades - Food & Snacks
Cotton Candy	Charades - Food & Snacks
Cupcake	Charades - Food & Snacks
Birthday Cake	Charades - Food & Snacks
Donut	Charades - Food & Snacks
Cookie	Charades - Food & Snacks
Brownie	Charades - Food & Snacks
Candy Bar	Charades - Food & Snacks
Gummy Bears	Charades - Food & Snacks
Jelly Beans	Charades - Food & Snacks
Chocolate	Charades - Food & Snacks
Marshmallow	Charades - Food & Snacks
S'mores	Charades - Food & Snacks
Apple	Charades - Food & Snacks
Banana	Charades - Food & Snacks
Orange	Charades - Food & Snacks
Grapes	Charades - Food & Snacks
Watermelon	Charades - Food & Snacks
Strawberry	Charades - Food & Snacks
Pineapple	Charades - Food & Snacks
Cherry	Charades - Food & Snacks
Lemon	Charades - Food & Snacks
Coconut	Charades - Food & Snacks
Corn on the Cob	Charades - Food & Snacks
Carrot	Charades - Food & Snacks
Broccoli	Charades - Food & Snacks
Celery Stick	Charades - Food & Snacks
Pickle	Charades - Food & Snacks
Sandwich	Charades - Food & Snacks
Grilled Cheese	Charades - Food & Snacks
PB&J	Charades - Food & Snacks
BLT	Charades - Food & Snacks
Sub Sandwich	Charades - Food & Snacks
Sushi	Charades - Food & Snacks
Ramen Noodles	Charades - Food & Snacks
Fried Rice	Charades - Food & Snacks
Egg Roll	Charades - Food & Snacks
Fortune Cookie	Charades - Food & Snacks
Pancakes	Charades - Food & Snacks
Waffles	Charades - Food & Snacks
French Toast	Charades - Food & Snacks
Cereal	Charades - Food & Snacks
Oatmeal	Charades - Food & Snacks
Bacon	Charades - Food & Snacks
Scrambled Eggs	Charades - Food & Snacks
Fried Egg	Charades - Food & Snacks
Toast	Charades - Food & Snacks
Bagel	Charades - Food & Snacks
Pretzel	Charades - Food & Snacks
Soft Pretzel	Charades - Food & Snacks
Chips	Charades - Food & Snacks
Crackers	Charades - Food & Snacks
Cheese Puffs	Charades - Food & Snacks
Milkshake	Charades - Food & Snacks
Smoothie	Charades - Food & Snacks
Slushie	Charades - Food & Snacks
Soda Pop	Charades - Food & Snacks
Juice Box	Charades - Food & Snacks
Lemonade	Charades - Food & Snacks
Hot Chocolate	Charades - Food & Snacks
Coffee	Charades - Food & Snacks
Tea	Charades - Food & Snacks
Milk	Charades - Food & Snacks
Soup	Charades - Food & Snacks
Chili	Charades - Food & Snacks
Mac and Cheese	Charades - Food & Snacks
Mashed Potatoes	Charades - Food & Snacks
Gravy	Charades - Food & Snacks
Fried Chicken	Charades - Food & Snacks
Chicken Wings	Charades - Food & Snacks
Ribs	Charades - Food & Snacks
Steak	Charades - Food & Snacks
Meatballs	Charades - Food & Snacks
Fish Sticks	Charades - Food & Snacks
Shrimp	Charades - Food & Snacks
Lobster	Charades - Food & Snacks
Crab Legs	Charades - Food & Snacks
Clam Chowder	Charades - Food & Snacks
Cheese	Charades - Food & Snacks
String Cheese	Charades - Food & Snacks
Cheese Pizza	Charades - Food & Snacks
Pepperoni Pizza	Charades - Food & Snacks
Cheese Quesadilla	Charades - Food & Snacks
Funnel Cake	Charades - Food & Snacks
Churro	Charades - Food & Snacks
Cinnamon Roll	Charades - Food & Snacks
Apple Pie	Charades - Food & Snacks
Ice Cream Sundae	Charades - Food & Snacks
Dog	Charades - Animals
Cat	Charades - Animals
Bunny	Charades - Animals
Hamster	Charades - Animals
Goldfish	Charades - Animals
Puppy	Charades - Animals
Kitten	Charades - Animals
Duckling	Charades - Animals
Chick	Charades - Animals
Piglet	Charades - Animals
Horse	Charades - Animals
Pony	Charades - Animals
Cow	Charades - Animals
Pig	Charades - Animals
Sheep	Charades - Animals
Goat	Charades - Animals
Chicken	Charades - Animals
Rooster	Charades - Animals
Duck	Charades - Animals
Goose	Charades - Animals
Frog	Charades - Animals
Toad	Charades - Animals
Turtle	Charades - Animals
Snail	Charades - Animals
Caterpillar	Charades - Animals
Butterfly	Charades - Animals
Ladybug	Charades - Animals
Bee	Charades - Animals
Ant	Charades - Animals
Spider	Charades - Animals
Lion	Charades - Animals
Tiger	Charades - Animals
Bear	Charades - Animals
Elephant	Charades - Animals
Giraffe	Charades - Animals
Zebra	Charades - Animals
Hippo	Charades - Animals
Rhino	Charades - Animals
Gorilla	Charades - Animals
Monkey	Charades - Animals
Kangaroo	Charades - Animals
Koala	Charades - Animals
Panda	Charades - Animals
Sloth	Charades - Animals
Penguin	Charades - Animals
Polar Bear	Charades - Animals
Seal	Charades - Animals
Walrus	Charades - Animals
Otter	Charades - Animals
Beaver	Charades - Animals
Dolphin	Charades - Animals
Whale	Charades - Animals
Shark	Charades - Animals
Octopus	Charades - Animals
Jellyfish	Charades - Animals
Starfish	Charades - Animals
Crab	Charades - Animals
Lobster	Charades - Animals
Seahorse	Charades - Animals
Clownfish	Charades - Animals
Eagle	Charades - Animals
Owl	Charades - Animals
Parrot	Charades - Animals
Flamingo	Charades - Animals
Peacock	Charades - Animals
Toucan	Charades - Animals
Hummingbird	Charades - Animals
Swan	Charades - Animals
Pelican	Charades - Animals
Woodpecker	Charades - Animals
Snake	Charades - Animals
Lizard	Charades - Animals
Alligator	Charades - Animals
Crocodile	Charades - Animals
Chameleon	Charades - Animals
T-Rex	Charades - Animals
Triceratops	Charades - Animals
Pterodactyl	Charades - Animals
Brontosaurus	Charades - Animals
Velociraptor	Charades - Animals
Unicorn	Charades - Animals
Dragon	Charades - Animals
Pegasus	Charades - Animals
Phoenix	Charades - Animals
Mermaid	Charades - Animals
Wolf	Charades - Animals
Fox	Charades - Animals
Deer	Charades - Animals
Moose	Charades - Animals
Reindeer	Charades - Animals
Squirrel	Charades - Animals
Chipmunk	Charades - Animals
Raccoon	Charades - Animals
Skunk	Charades - Animals
Hedgehog	Charades - Animals
Bat	Charades - Animals
Mouse	Charades - Animals
Cheetah	Charades - Animals
Camel	Charades - Animals
Llama	Charades - Animals
Alligator	Animals - Easy
Ant	Animals - Easy
Anteater	Animals - Easy
Bat	Animals - Easy
Bear	Animals - Easy
Beaver	Animals - Easy
Bee	Animals - Easy
Beetle	Animals - Easy
Bison	Animals - Easy
Butterfly	Animals - Easy
Camel	Animals - Easy
Capybara	Animals - Easy
Cat	Animals - Easy
Caterpillar	Animals - Easy
Cheetah	Animals - Easy
Chicken	Animals - Easy
Cow	Animals - Easy
Crab	Animals - Easy
Deer	Animals - Easy
Dog	Animals - Easy
Dolphin	Animals - Easy
Donkey	Animals - Easy
Duck	Animals - Easy
Eagle	Animals - Easy
Elephant	Animals - Easy
Flamingo	Animals - Easy
Frog	Animals - Easy
Giraffe	Animals - Easy
Goat	Animals - Easy
Goldfish	Animals - Easy
Goose	Animals - Easy
Gorilla	Animals - Easy
Great White Shark	Animals - Easy
Guinea Pig	Animals - Easy
Hammerhead Shark	Animals - Easy
Hamster	Animals - Easy
Hedgehog	Animals - Easy
Hippo	Animals - Easy
Horse	Animals - Easy
Jellyfish	Animals - Easy
Kangaroo	Animals - Easy
King Cobra	Animals - Easy
Koala	Animals - Easy
Ladybug	Animals - Easy
Leopard	Animals - Easy
Lion	Animals - Easy
Lizard	Animals - Easy
Lobster	Animals - Easy
Manatee	Animals - Easy
Meerkat	Animals - Easy
Monkey	Animals - Easy
Moose	Animals - Easy
Mouse	Animals - Easy
Octopus	Animals - Easy
Orca	Animals - Easy
Owl	Animals - Easy
Panda	Animals - Easy
Parrot	Animals - Easy
Peacock	Animals - Easy
Penguin	Animals - Easy
Pig	Animals - Easy
Platypus	Animals - Easy
Polar Bear	Animals - Easy
Porcupine	Animals - Easy
Rabbit	Animals - Easy
Raccoon	Animals - Easy
Rat	Animals - Easy
Rattlesnake	Animals - Easy
Reindeer	Animals - Easy
Rhino	Animals - Easy
Salamander	Animals - Easy
Scorpion	Animals - Easy
Sea Turtle	Animals - Easy
Seahorse	Animals - Easy
Seal	Animals - Easy
Shark	Animals - Easy
Sheep	Animals - Easy
Sloth	Animals - Easy
Snake	Animals - Easy
Spider	Animals - Easy
Squirrel	Animals - Easy
Starfish	Animals - Easy
Stingray	Animals - Easy
Swan	Animals - Easy
Tarantula	Animals - Easy
Tiger	Animals - Easy
Tortoise	Animals - Easy
Toucan	Animals - Easy
Turkey	Animals - Easy
Turtle	Animals - Easy
Walrus	Animals - Easy
Whale	Animals - Easy
Wolf	Animals - Easy
Wolverine	Animals - Easy
Woodpecker	Animals - Easy
Zebra	Animals - Easy
Albatross	Animals - Medium
Alpaca	Animals - Medium
Anaconda	Animals - Medium
Antelope	Animals - Medium
Armadillo	Animals - Medium
Axolotl	Animals - Medium
Barracuda	Animals - Medium
Beluga	Animals - Medium
Black Bear	Animals - Medium
Blue Whale	Animals - Medium
Capuchin Monkey	Animals - Medium
Caribou	Animals - Medium
Chameleon	Animals - Medium
Chimpanzee	Animals - Medium
Chipmunk	Animals - Medium
Coyote	Animals - Medium
Crocodile	Animals - Medium
Cuttlefish	Animals - Medium
Dugong	Animals - Medium
Echidna	Animals - Medium
Emu	Animals - Medium
Fox	Animals - Medium
Frilled Lizard	Animals - Medium
Gecko	Animals - Medium
Gibbon	Animals - Medium
Gila Monster	Animals - Medium
Grizzly Bear	Animals - Medium
Honey Badger	Animals - Medium
Horseshoe Crab	Animals - Medium
Humpback Whale	Animals - Medium
Hyena	Animals - Medium
Iguana	Animals - Medium
Jaguar	Animals - Medium
Komodo Dragon	Animals - Medium
Llama	Animals - Medium
Manta Ray	Animals - Medium
Marine Iguana	Animals - Medium
Marmoset	Animals - Medium
Marten	Animals - Medium
Mink	Animals - Medium
Moray Eel	Animals - Medium
Musk Ox	Animals - Medium
Narwhal	Animals - Medium
Newt	Animals - Medium
Orangutan	Animals - Medium
Otter	Animals - Medium
Poison Dart Frog	Animals - Medium
Portuguese Man O' War	Animals - Medium
Praying Mantis	Animals - Medium
Puffin	Animals - Medium
Python	Animals - Medium
Quokka	Animals - Medium
Sailfish	Animals - Medium
Scorpion	Animals - Medium
Skunk	Animals - Medium
Sperm Whale	Animals - Medium
Squid	Animals - Medium
Stick Insect	Animals - Medium
Tasmanian Devil	Animals - Medium
Tuna	Animals - Medium
Viper	Animals - Medium
Weasel	Animals - Medium
Whale Shark	Animals - Medium
Wombat	Animals - Medium
Aye-Aye	Animals - Hard
Bearded Dragon	Animals - Hard
Black Mamba	Animals - Hard
Bonobo	Animals - Hard
Box Jellyfish	Animals - Hard
Bullet Ant	Animals - Hard
Caiman	Animals - Hard
Cane Toad	Animals - Hard
Cape Buffalo	Animals - Hard
Cassowary	Animals - Hard
Civet	Animals - Hard
Coati	Animals - Hard
Fisher	Animals - Hard
Howler Monkey	Animals - Hard
Kinkajou	Animals - Hard
Kookaburra	Animals - Hard
Leafcutter Ant	Animals - Hard
Mandrill	Animals - Hard
Marlin	Animals - Hard
Nautilus	Animals - Hard
Ocelot	Animals - Hard
Okapi	Animals - Hard
Pangolin	Animals - Hard
Proboscis Monkey	Animals - Hard
Serval	Animals - Hard
Shoebill	Animals - Hard
Star-Nosed Mole	Animals - Hard
Stoat	Animals - Hard
Takin	Animals - Hard
Tamarin	Animals - Hard
Tapir	Animals - Hard
Zebra Finch	Animals - Hard
Toaster	Household Objects
Lamp	Household Objects
Sofa	Household Objects
Fridge	Household Objects
Microwave	Household Objects
Television	Household Objects
Bed	Household Objects
Chair	Household Objects
Table	Household Objects
Mirror	Household Objects
Clock	Household Objects
Vase	Household Objects
Rug	Household Objects
Curtain	Household Objects
Pillow	Household Objects
Blanket	Household Objects
Towel	Household Objects
Soap	Household Objects
Toothbrush	Household Objects
Comb	Household Objects
Blender	Household Objects
Coffee Maker	Household Objects
Dishwasher	Household Objects
Washing Machine	Household Objects
Dryer	Household Objects
Iron	Household Objects
Vacuum Cleaner	Household Objects
Broom	Household Objects
Mop	Household Objects
Dustpan	Household Objects
Trash Can	Household Objects
Recycling Bin	Household Objects
Bookshelf	Household Objects
Dresser	Household Objects
Nightstand	Household Objects
Desk	Household Objects
Filing Cabinet	Household Objects
Picture Frame	Household Objects
Candle	Household Objects
Plant Pot	Household Objects
Couch	Household Objects
Recliner	Household Objects
Ottoman	Household Objects
Coffee Table	Household Objects
End Table	Household Objects
Dining Table	Household Objects
Bar Stool	Household Objects
Rocking Chair	Household Objects
Bean Bag	Household Objects
Hammock	Household Objects
Chandelier	Household Objects
Ceiling Fan	Household Objects
Floor Lamp	Household Objects
Nightlight	Household Objects
Light Switch	Household Objects
Door Handle	Household Objects
Window Blinds	Household Objects
Doormat	Household Objects
Coat Rack	Household Objects
Shoe Rack	Household Objects
Laundry Basket	Household Objects
Hamper	Household Objects
Shower Curtain	Household Objects
Bath Mat	Household Objects
Toilet Paper	Household Objects
Plunger	Household Objects
Toilet Brush	Household Objects
Hair Dryer	Household Objects
Curling Iron	Household Objects
Electric Razor	Household Objects
Scale	Household Objects
First Aid Kit	Household Objects
Fire Extinguisher	Household Objects
Smoke Detector	Household Objects
Thermostat	Household Objects
Santa Claus	Christmas Kids Party
Rudolph	Christmas Kids Party
Snowman	Christmas Kids Party
Elf	Christmas Kids Party
Reindeer	Christmas Kids Party
Christmas Tree	Christmas Kids Party
Candy Cane	Christmas Kids Party
Gingerbread Man	Christmas Kids Party
Snowflake	Christmas Kids Party
Present	Christmas Kids Party
Stocking	Christmas Kids Party
Jingle Bells	Christmas Kids Party
Hot Cocoa	Christmas Kids Party
Mittens	Christmas Kids Party
Scarf	Christmas Kids Party
Snow Angel	Christmas Kids Party
Igloo	Christmas Kids Party
Penguin	Christmas Kids Party
Polar Bear	Christmas Kids Party
Sleigh	Christmas Kids Party
Wreath	Christmas Kids Party
Ornament	Christmas Kids Party
Star	Christmas Kids Party
Angel	Christmas Kids Party
Snowball	Christmas Kids Party
Winter Hat	Christmas Kids Party
Earmuffs	Christmas Kids Party
Boots	Christmas Kids Party
Fireplace	Christmas Kids Party
Chimney	Christmas Kids Party
Cookies	Christmas Kids Party
Milk	Christmas Kids Party
Gingerbread House	Christmas Kids Party
Frosty	Christmas Kids Party
North Pole	Christmas Kids Party
Toy Workshop	Christmas Kids Party
Mrs. Claus	Christmas Kids Party
Nutcracker	Christmas Kids Party
Drummer Boy	Christmas Kids Party
Christmas Lights	Christmas Kids Party
Caroling	Christmas Kids Party
Mistletoe	Christmas Kids Party
Holly	Christmas Kids Party
Poinsettia	Christmas Kids Party
Snow Globe	Christmas Kids Party
Tinsel	Christmas Kids Party
Garland	Christmas Kids Party
Bow	Christmas Kids Party
Ribbon	Christmas Kids Party
Gift Wrap	Christmas Kids Party
Ice Skating	Christmas Kids Party
Sledding	Christmas Kids Party
Snowball Fight	Christmas Kids Party
Building a Snowman	Christmas Kids Party
Hot Chocolate	Christmas Kids Party
Marshmallows	Christmas Kids Party
Candy	Christmas Kids Party
Sugar Plum	Christmas Kids Party
Sugarplum Fairy	Christmas Kids Party
Toy Soldier	Christmas Kids Party
Jack Frost	Christmas Kids Party
Winter Wonderland	Christmas Kids Party
Icicle	Christmas Kids Party
Frozen Pond	Christmas Kids Party
Snowy Mountain	Christmas Kids Party
Cozy Blanket	Christmas Kids Party
Fireplace	Christmas Kids Party
Christmas Movie	Christmas Kids Party
Christmas Song	Christmas Kids Party
Jingle	Christmas Kids Party
Festive	Christmas Kids Party
Merry	Christmas Kids Party
Jolly	Christmas Kids Party
Sparkly	Christmas Kids Party
Magical	Christmas Kids Party
Twinkling Lights	Christmas Kids Party
Red Nose	Christmas Kids Party
Antlers	Christmas Kids Party
Santa Hat	Christmas Kids Party
Elf Shoes	Christmas Kids Party
Toy Train	Christmas Kids Party
Teddy Bear	Christmas Kids Party
Doll	Christmas Kids Party
Toy Car	Christmas Kids Party
Building Blocks	Christmas Kids Party
Puzzle	Christmas Kids Party
Board Game	Christmas Kids Party
Coloring Book	Christmas Kids Party
Crayons	Christmas Kids Party
Play-Doh	Christmas Kids Party
Balloon	Christmas Kids Party
Party Hat	Christmas Kids Party
Noisemaker	Christmas Kids Party
Confetti	Christmas Kids Party
Streamers	Christmas Kids Party
Cupcake	Christmas Kids Party
Birthday Cake	Christmas Kids Party
Ice Cream	Christmas Kids Party
Lollipop	Christmas Kids Party
Chocolate	Christmas Kids Party
Pizza	Family Fun
Hamburger	Family Fun
Ice Cream	Family Fun
Popcorn	Family Fun
Spaghetti	Family Fun
Pancakes	Family Fun
Waffles	Family Fun
Tacos	Family Fun
Sandwich	Family Fun
Hot Dog	Family Fun
Bicycle	Family Fun
Skateboard	Family Fun
Scooter	Family Fun
Roller Skates	Family Fun
Trampoline	Family Fun
Swing	Family Fun
Slide	Family Fun
Seesaw	Family Fun
Merry-Go-Round	Family Fun
Jungle Gym	Family Fun
Beach Ball	Family Fun
Frisbee	Family Fun
Kite	Family Fun
Jump Rope	Family Fun
Hula Hoop	Family Fun
Bubble Wand	Family Fun
Water Balloon	Family Fun
Sprinkler	Family Fun
Pool Noodle	Family Fun
Floatie	Family Fun
Camping	Family Fun
Tent	Family Fun
Campfire	Family Fun
Marshmallow	Family Fun
Sleeping Bag	Family Fun
Flashlight	Family Fun
Binoculars	Family Fun
Compass	Family Fun
Hiking	Family Fun
Fishing Rod	Family Fun
Treehouse	Family Fun
Fort	Family Fun
Pillow Fort	Family Fun
Blanket Fort	Family Fun
Hide and Seek	Family Fun
Tag	Family Fun
Duck Duck Goose	Family Fun
Red Light Green Light	Family Fun
Simon Says	Family Fun
Musical Chairs	Family Fun
Karaoke	Family Fun
Dance Party	Family Fun
Limbo	Family Fun
Freeze Dance	Family Fun
Conga Line	Family Fun
Magic Show	Family Fun
Puppet Show	Family Fun
Shadow Puppets	Family Fun
Charades	Family Fun
Pictionary	Family Fun
Bowling	Family Fun
Mini Golf	Family Fun
Arcade	Family Fun
Bumper Cars	Family Fun
Ferris Wheel	Family Fun
Roller Coaster	Family Fun
Cotton Candy	Family Fun
Funnel Cake	Family Fun
Corn Dog	Family Fun
Snow Cone	Family Fun
Zoo	Family Fun
Aquarium	Family Fun
Museum	Family Fun
Planetarium	Family Fun
Water Park	Family Fun
Beach	Family Fun
Sandcastle	Family Fun
Seashell	Family Fun
Surfboard	Family Fun
Snorkeling	Family Fun
Airplane	Family Fun
Hot Air Balloon	Family Fun
Helicopter	Family Fun
Train	Family Fun
School Bus	Family Fun
Fire Truck	Family Fun
Police Car	Family Fun
Ambulance	Family Fun
Tow Truck	Family Fun
Dump Truck	Family Fun
Superhero	Family Fun
Princess	Family Fun
Pirate	Family Fun
Cowboy	Family Fun
Astronaut	Family Fun
Dinosaur	Family Fun
Robot	Family Fun
Unicorn	Family Fun
Dragon	Family Fun
Mermaid	Family Fun
Alabama	US Geography
Montgomery	US Geography
Alaska	US Geography
Juneau	US Geography
Arizona	US Geography
Phoenix	US Geography
Arkansas	US Geography
Little Rock	US Geography
California	US Geography
Sacramento	US Geography
Colorado	US Geography
Denver	US Geography
Connecticut	US Geography
Hartford	US Geography
Delaware	US Geography
Dover	US Geography
Florida	US Geography
Tallahassee	US Geography
Georgia	US Geography
Atlanta	US Geography
Hawaii	US Geography
Honolulu	US Geography
Idaho	US Geography
Boise	US Geography
Illinois	US Geography
Springfield	US Geography
Indiana	US Geography
Indianapolis	US Geography
Iowa	US Geography
Des Moines	US Geography
Kansas	US Geography
Topeka	US Geography
Kentucky	US Geography
Frankfort	US Geography
Louisiana	US Geography
Baton Rouge	US Geography
Maine	US Geography
Augusta	US Geography
Maryland	US Geography
Annapolis	US Geography
Massachusetts	US Geography
Boston	US Geography
Michigan	US Geography
Lansing	US Geography
Minnesota	US Geography
Saint Paul	US Geography
Mississippi	US Geography
Jackson	US Geography
Missouri	US Geography
Jefferson City	US Geography
Montana	US Geography
Helena	US Geography
Nebraska	US Geography
Lincoln	US Geography
Nevada	US Geography
Carson City	US Geography
New Hampshire	US Geography
Concord	US Geography
New Jersey	US Geography
Trenton	US Geography
New Mexico	US Geography
Santa Fe	US Geography
New York	US Geography
Albany	US Geography
North Carolina	US Geography
Raleigh	US Geography
North Dakota	US Geography
Bismarck	US Geography
Ohio	US Geography
Columbus	US Geography
Oklahoma	US Geography
Oklahoma City	US Geography
Oregon	US Geography
Salem	US Geography
Pennsylvania	US Geography
Harrisburg	US Geography
Rhode Island	US Geography
Providence	US Geography
South Carolina	US Geography
Columbia	US Geography
South Dakota	US Geography
Pierre	US Geography
Tennessee	US Geography
Nashville	US Geography
Texas	US Geography
Austin	US Geography
Utah	US Geography
Salt Lake City	US Geography
Vermont	US Geography
Montpelier	US Geography
Virginia	US Geography
Richmond	US Geography
Washington	US Geography
Olympia	US Geography
West Virginia	US Geography
Charleston	US Geography
Wisconsin	US Geography
Madison	US Geography
Wyoming	US Geography
Cheyenne	US Geography
New York City	US Geography
Los Angeles	US Geography
Chicago	US Geography
Houston	US Geography
Miami	US Geography
San Francisco	US Geography
Seattle	US Geography
Las Vegas	US Geography
San Diego	US Geography
Dallas	US Geography
San Antonio	US Geography
Philadelphia	US Geography
Detroit	US Geography
Portland	US Geography
Minneapolis	US Geography
New Orleans	US Geography
Baltimore	US Geography
Milwaukee	US Geography
Cleveland	US Geography
Pittsburgh	US Geography
Cincinnati	US Geography
Kansas City	US Geography
Tampa	US Geography
Orlando	US Geography
Charlotte	US Geography
Statue of Liberty	US Geography
Golden Gate Bridge	US Geography
Mount Rushmore	US Geography
Hollywood Sign	US Geography
Empire State Building	US Geography
White House	US Geography
Lincoln Memorial	US Geography
Washington Monument	US Geography
Space Needle	US Geography
Gateway Arch	US Geography
Brooklyn Bridge	US Geography
Hoover Dam	US Geography
Freedom Trail	US Geography
Alcatraz Island	US Geography
Pearl Harbor	US Geography
Independence Hall	US Geography
Liberty Bell	US Geography
Niagara Falls	US Geography
Times Square	US Geography
Central Park	US Geography
Grand Central Station	US Geography
Las Vegas Strip	US Geography
Navy Pier	US Geography
Fisherman's Wharf	US Geography
French Quarter	US Geography
Grand Canyon	US Geography
Yellowstone	US Geography
Yosemite	US Geography
Zion	US Geography
Glacier Nat'l Park	US Geography
Rocky Mountain	US Geography
Great Smoky Mountains	US Geography
Acadia	US Geography
Olympic Nat'l Park	US Geography
Joshua Tree	US Geography
Death Valley	US Geography
Everglades	US Geography
Bryce Canyon	US Geography
Arches	US Geography
Sequoia	US Geography
Redwood	US Geography
Denali	US Geography
Hawaii Volcanoes	US Geography
Crater Lake	US Geography
Mesa Verde	US Geography
Badlands	US Geography
Shenandoah	US Geography
Big Bend	US Geography
Canyonlands	US Geography
Capitol Reef	US Geography
Mississippi River	US Geography
Colorado River	US Geography
Missouri River	US Geography
Great Lakes	US Geography
Lake Michigan	US Geography
Lake Superior	US Geography
Lake Erie	US Geography
Lake Tahoe	US Geography
Chesapeake Bay	US Geography
Puget Sound	US Geography
Florida Keys	US Geography
Cape Cod	US Geography
Martha's Vineyard	US Geography
Long Island	US Geography
Manhattan	US Geography
Hollywood	US Geography
Silicon Valley	US Geography
Wall Street	US Geography
Broadway	US Geography
Bourbon Street	US Geography
Route 66	US Geography
Pacific Coast Highway	US Geography
Appalachian Trail	US Geography
Mount Whitney	US Geography
Mount Rainier	US Geography
Canada	World Geography
Ottawa	World Geography
Mexico	World Geography
Mexico City	World Geography
Brazil	World Geography
Brasilia	World Geography
Argentina	World Geography
Buenos Aires	World Geography
Chile	World Geography
Santiago	World Geography
Peru	World Geography
Lima	World Geography
Colombia	World Geography
Bogota	World Geography
Venezuela	World Geography
Caracas	World Geography
Ecuador	World Geography
Quito	World Geography
United Kingdom	World Geography
London	World Geography
France	World Geography
Paris	World Geography
Germany	World Geography
Berlin	World Geography
Italy	World Geography
Rome	World Geography
Spain	World Geography
Madrid	World Geography
Portugal	World Geography
Lisbon	World Geography
Netherlands	World Geography
Amsterdam	World Geography
Belgium	World Geography
Brussels	World Geography
Switzerland	World Geography
Bern	World Geography
Austria	World Geography
Vienna	World Geography
Poland	World Geography
Warsaw	World Geography
Greece	World Geography
Athens	World Geography
Sweden	World Geography
Stockholm	World Geography
Norway	World Geography
Oslo	World Geography
Denmark	World Geography
Copenhagen	World Geography
Finland	World Geography
Helsinki	World Geography
Ireland	World Geography
Dublin	World Geography
Scotland	World Geography
Edinburgh	World Geography
Russia	World Geography
Moscow	World Geography
Ukraine	World Geography
Kyiv	World Geography
Turkey	World Geography
Ankara	World Geography
China	World Geography
Beijing	World Geography
Japan	World Geography
Tokyo	World Geography
South Korea	World Geography
Seoul	World Geography
India	World Geography
New Delhi	World Geography
Thailand	World Geography
Bangkok	World Geography
Vietnam	World Geography
Hanoi	World Geography
Indonesia	World Geography
Jakarta	World Geography
Philippines	World Geography
Manila	World Geography
Malaysia	World Geography
Kuala Lumpur	World Geography
Singapore	World Geography
Australia	World Geography
Canberra	World Geography
New Zealand	World Geography
Wellington	World Geography
Egypt	World Geography
Cairo	World Geography
South Africa	World Geography
Pretoria	World Geography
Morocco	World Geography
Rabat	World Geography
Kenya	World Geography
Nairobi	World Geography
Nigeria	World Geography
Abuja	World Geography
Ethiopia	World Geography
Addis Ababa	World Geography
Israel	World Geography
Jerusalem	World Geography
Saudi Arabia	World Geography
Riyadh	World Geography
United Arab Emirates	World Geography
Abu Dhabi	World Geography
Toronto	World Geography
Vancouver	World Geography
Montreal	World Geography
Sydney	World Geography
Melbourne	World Geography
Auckland	World Geography
Rio de Janeiro	World Geography
Sao Paulo	World Geography
Barcelona	World Geography
Milan	World Geography
Munich	World Geography
Prague	World Geography
Budapest	World Geography
Venice	World Geography
Florence	World Geography
Nice	World Geography
Geneva	World Geography
Zurich	World Geography
Hong Kong	World Geography
Shanghai	World Geography
Dubai	World Geography
Mumbai	World Geography
Bangalore	World Geography
Cape Town	World Geography
Marrakech	World Geography
Istanbul	World Geography
St. Petersburg	World Geography
Kyoto	World Geography
Osaka	World Geography
Atlantic Ocean	World Geography
Pacific Ocean	World Geography
Indian Ocean	World Geography
Arctic Ocean	World Geography
Southern Ocean	World Geography
Mediterranean Sea	World Geography
Caribbean Sea	World Geography
Red Sea	World Geography
Black Sea	World Geography
Baltic Sea	World Geography
North Sea	World Geography
South China Sea	World Geography
Bay of Bengal	World Geography
Persian Gulf	World Geography
Gulf of Mexico	World Geography
Amazon River	World Geography
Nile River	World Geography
Ganges River	World Geography
Yangtze River	World Geography
Danube River	World Geography
Thames River	World Geography
Seine River	World Geography
Rhine River	World Geography
Volga River	World Geography
Congo River	World Geography
Dead Sea	World Geography
Caspian Sea	World Geography
Lake Victoria	World Geography
Lake Baikal	World Geography
Great Barrier Reef	World Geography
Eiffel Tower	World Geography
Big Ben	World Geography
Colosseum	World Geography
Leaning Tower of Pisa	World Geography
Stonehenge	World Geography
Taj Mahal	World Geography
Great Wall of China	World Geography
Machu Picchu	World Geography
Christ the Redeemer	World Geography
Petra	World Geography
Pyramids of Giza	World Geography
Sphinx	World Geography
Acropolis	World Geography
Parthenon	World Geography
Tower of London	World Geography
Buckingham Palace	World Geography
Vatican City	World Geography
Sistine Chapel	World Geography
Notre Dame	World Geography
Louvre	World Geography
Sydney Opera House	World Geography
Burj Khalifa	World Geography
Mount Everest	World Geography
Mount Fuji	World Geography
Matterhorn	World Geography
Amazon Rainforest	World Geography
Sahara Desert	World Geography
Gobi Desert	World Geography
Himalayas	World Geography
Alps	World Geography
Andes Mountains	World Geography
Victoria Falls	World Geography
Angel Falls	World Geography
Iguazu Falls	World Geography
Northern Lights	World Geography
Santorini	World Geography
Bali	World Geography
Fiji	World Geography
Maldives	World Geography
Galapagos Islands	World Geography
爱 (ài)	Mandarin
不好 (bù hǎo)	Mandarin
不是 (búshì)	Mandarin
不 (bù)	Mandarin
不可以 (bùxíng)	Mandarin
吃 (chī)	Mandarin
茶 (chá)	Mandarin
唱 (chàng)	Mandarin
车 (chē)	Mandarin
大 (dà)	Mandarin
打开 (dǎkāi)	Mandarin
读 (dú)	Mandarin
对不起 (duìbùqǐ)	Mandarin
放 (fàng)	Mandarin
给 (gěi)	Mandarin
高兴 (gāoxìng)	Mandarin
歌 (gē)	Mandarin
狗 (gǒu)	Mandarin
关上 (guānshàng)	Mandarin
很 (hěn)	Mandarin
好 (hǎo)	Mandarin
喝 (hē)	Mandarin
医院 (yīyuàn)	Mandarin
会 (huì)	Mandarin
画 (huà)	Mandarin
家 (jiā)	Mandarin
今天 (jīntiān)	Mandarin
跳 (tiào)	Mandarin
跳舞 (tiàowǔ)	Mandarin
咖啡 (kāfēi)	Mandarin
看 (kàn)	Mandarin
来 (lái)	Mandarin
冷 (lěng)	Mandarin
老师 (lǎoshī)	Mandarin
妈妈 (māma)	Mandarin
猫 (māo)	Mandarin
买 (mǎi)	Mandarin
没有 (méiyǒu)	Mandarin
明天 (míngtiān)	Mandarin
名字 (míngzi)	Mandarin
米饭 (mǐfàn)	Mandarin
你 (nǐ)	Mandarin
年龄 (niánlíng)	Mandarin
拿 (ná)	Mandarin
哪个 (nǎge)	Mandarin
哪里 (nǎlǐ)	Mandarin
难过 (nánguò)	Mandarin
牛奶 (niúnǎi)	Mandarin
朋友 (péngyǒu)	Mandarin
苹果 (píngguǒ)	Mandarin
钱 (qián)	Mandarin
去 (qù)	Mandarin
热 (rè)	Mandarin
跑 (pǎo)	Mandarin
请 (qǐng)	Mandarin
坐 (zuò)	Mandarin
学校 (xuéxiào)	Mandarin
谁 (shéi)	Mandarin
书 (shū)	Mandarin
睡觉 (shuìjiào)	Mandarin
水 (shuǐ)	Mandarin
她说 (tā shuō)	Mandarin
他 (tā)	Mandarin
她 (tā)	Mandarin
听 (tīng)	Mandarin
他们 (tāmen)	Mandarin
我们 (wǒmen)	Mandarin
我 (wǒ)	Mandarin
超市 (chāoshì)	Mandarin
香蕉 (xiāngjiāo)	Mandarin
小 (xiǎo)	Mandarin
谢谢 (xièxiè)	Mandarin
写 (xiě)	Mandarin
学习 (xuéxí)	Mandarin
需要 (xūyào)	Mandarin
学 (xué)	Mandarin
昨天 (zuótiān)	Mandarin
再见 (zàijiàn)	Mandarin
站 (zhàn)	Mandarin
桌子 (zhuōzi)	Mandarin
椅子 (yǐzi)	Mandarin
这个 (zhège)	Mandarin
怎么 (zěnme)	Mandarin
做什么 (zuò shénme)	Mandarin
找 (zhǎo)	Mandarin
公园 (gōngyuán)	Mandarin
工作 (gōngzuò)	Mandarin
说什么 (shuō shénme)	Mandarin
现在 (xiànzài)	Mandarin
星期一 (xīngqīyī)	Mandarin
学生 (xuéshēng)	Mandarin
说话 (shuōhuà)	Mandarin
说 (shuō)	Mandarin
为什么 (wèishénme)	Mandarin
什么时候 (shénme shíhou)	Mandarin
那里 (nàlǐ)	Mandarin
这里 (zhèlǐ)	Mandarin
那个 (nàge)	Mandarin
卖 (mài)	Mandarin
面条 (miàntiáo)	Mandarin
爸爸 (bàba)	Mandarin
笔 (bǐ)	Mandarin
是 (shì)	Mandarin
喜欢 (xǐhuan)	Mandarin
你好 nǐ hǎo [hello]	Mandarin-Beginner
谢谢 xièxiè [thank you]	Mandarin-Beginner
再见 zàijiàn [goodbye]	Mandarin-Beginner
请 qǐng [please]	Mandarin-Beginner
对不起 duìbùqǐ [sorry]	Mandarin-Beginner
是 shì [yes]	Mandarin-Beginner
不是 búshì [no]	Mandarin-Beginner
我 wǒ [I]	Mandarin-Beginner
你 nǐ [you]	Mandarin-Beginner
他 tā [he]	Mandarin-Beginner
她 tā [she]	Mandarin-Beginner
我们 wǒmen [we]	Mandarin-Beginner
他们 tāmen [they]	Mandarin-Beginner
吃 chī [eat]	Mandarin-Beginner
喝 hē [drink]	Mandarin-Beginner
看 kàn [look/watch]	Mandarin-Beginner
说 shuō [speak/say]	Mandarin-Beginner
听 tīng [listen]	Mandarin-Beginner
喜欢 xǐhuan [like]	Mandarin-Beginner
爱 ài [love]	Mandarin-Beginner
米饭 mǐfàn [rice]	Mandarin-Beginner
面条 miàntiáo [noodles]	Mandarin-Beginner
苹果 píngguǒ [apple]	Mandarin-Beginner
香蕉 xiāngjiāo [banana]	Mandarin-Beginner
牛奶 niúnǎi [milk]	Mandarin-Beginner
水 shuǐ [water]	Mandarin-Beginner
茶 chá [tea]	Mandarin-Beginner
咖啡 kāfēi [coffee]	Mandarin-Beginner
学校 xuéxiào [school]	Mandarin-Beginner
老师 lǎoshī [teacher]	Mandarin-Beginner
学生 xuéshēng [student]	Mandarin-Beginner
书 shū [book]	Mandarin-Beginner
笔 bǐ [pen]	Mandarin-Beginner
桌子 zhuōzi [table]	Mandarin-Beginner
椅子 yǐzi [chair]	Mandarin-Beginner
家 jiā [home/family]	Mandarin-Beginner
妈妈 māma [mom]	Mandarin-Beginner
爸爸 bàba [dad]	Mandarin-Beginner
朋友 péngyǒu [friend]	Mandarin-Beginner
狗 gǒu [dog]	Mandarin-Beginner
猫 māo [cat]	Mandarin-Beginner
车 chē [car]	Mandarin-Beginner
钱 qián [money]	Mandarin-Beginner
工作 gōngzuò [work]	Mandarin-Beginner
睡觉 shuìjiào [sleep]	Mandarin-Beginner
走 zǒu [walk]	Mandarin-Beginner
来 lái [come]	Mandarin-Beginner
去 qù [go]	Mandarin-Beginner
天气 tiānqì [weather]	Mandarin-Beginner
今天 jīntiān [today]	Mandarin-Beginner
明天 míngtiān [tomorrow]	Mandarin-Beginner
帮忙 bāngmáng [help]	Mandarin-Intermediate
记得 jìde [remember]	Mandarin-Intermediate
忘记 wàngjì [forget]	Mandarin-Intermediate
明白 míngbai [understand]	Mandarin-Intermediate
练习 liànxí [practice]	Mandarin-Intermediate
问题 wèntí [problem/question]	Mandarin-Intermediate
回答 huídá [answer]	Mandarin-Intermediate
超市 chāoshì [supermarket]	Mandarin-Intermediate
医院 yīyuàn [hospital]	Mandarin-Intermediate
火车站 huǒchēzhàn [train station]	Mandarin-Intermediate
机场 jīchǎng [airport]	Mandarin-Intermediate
电影院 diànyǐngyuàn [cinema]	Mandarin-Intermediate
生日快乐 shēngrì kuàilè [happy birthday]	Mandarin-Intermediate
没问题 méi wèntí [no problem]	Mandarin-Intermediate
太好了 tài hǎo le [great/awesome]	Mandarin-Intermediate
怎么样 zěnmeyàng [how is it]	Mandarin-Intermediate
几点 jǐ diǎn [what time]	Mandarin-Intermediate
多少钱 duōshǎo qián [how much]	Mandarin-Intermediate
打开 dǎkāi [open]	Mandarin-Intermediate
关上 guānshàng [close]	Mandarin-Intermediate
洗澡 xǐzǎo [take a shower]	Mandarin-Intermediate
打电话 dǎ diànhuà [make a phone call]	Mandarin-Intermediate
拍照 pāizhào [take a photo]	Mandarin-Intermediate
等等 děngdeng [wait]	Mandarin-Intermediate
小心 xiǎoxīn [be careful]	Mandarin-Intermediate
成功 chénggōng [success]	Mandarin-Intermediate
失败 shībài [failure]	Mandarin-Intermediate
努力 nǔlì [effort/hard work]	Mandarin-Intermediate
梦想 mèngxiǎng [dream]	Mandarin-Intermediate
计划 jìhuà [plan]	Mandarin-Intermediate
天气预报 tiānqì yùbào [weather forecast]	Mandarin-Intermediate
交通灯 jiāotōngdēng [traffic light]	Mandarin-Intermediate
身份证 shēnfènzhèng [ID card]	Mandarin-Intermediate
信用卡 xìnyòngkǎ [credit card]	Mandarin-Intermediate
菜单 càidān [menu]	Mandarin-Intermediate
服务员 fúwùyuán [waiter/waitress]	Mandarin-Intermediate
推荐 tuījiàn [recommend]	Mandarin-Intermediate
味道怎么样 wèidào zěnmeyàng [how does it taste]	Mandarin-Intermediate
太贵了 tài guì le [too expensive]	Mandarin-Intermediate
打折 dǎzhé [discount]	Mandarin-Intermediate
考试 kǎoshì [exam/test]	Mandarin-Intermediate
复习 fùxí [review]	Mandarin-Intermediate
提高 tígāo [improve]	Mandarin-Intermediate
发音 fāyīn [pronunciation]	Mandarin-Intermediate
语法 yǔfǎ [grammar]	Mandarin-Intermediate
文化 wénhuà [culture]	Mandarin-Intermediate
节日 jiérì [holiday]	Mandarin-Intermediate
春节 chūnjié [Spring Festival]	Mandarin-Intermediate
中秋节 zhōngqiūjié [Mid-Autumn Festival]	Mandarin-Intermediate
龙年 lóngnián [Year of the Dragon]	Mandarin-Intermediate
健康 jiànkāng [health]	Mandarin-Intermediate
xin chào [hello]	Vietnamese-Beginner
cảm ơn [thank you]	Vietnamese-Beginner
tạm biệt [goodbye]	Vietnamese-Beginner
làm ơn [please]	Vietnamese-Beginner
xin lỗi [sorry]	Vietnamese-Beginner
vâng [yes]	Vietnamese-Beginner
không [no]	Vietnamese-Beginner
tôi [I]	Vietnamese-Beginner
bạn [you]	Vietnamese-Beginner
anh ấy [he]	Vietnamese-Beginner
cô ấy [she]	Vietnamese-Beginner
chúng tôi [we]	Vietnamese-Beginner
họ [they]	Vietnamese-Beginner
ăn [eat]	Vietnamese-Beginner
uống [drink]	Vietnamese-Beginner
nhìn [look/watch]	Vietnamese-Beginner
nói [speak/say]	Vietnamese-Beginner
nghe [listen]	Vietnamese-Beginner
thích [like]	Vietnamese-Beginner
yêu [love]	Vietnamese-Beginner
cơm [rice]	Vietnamese-Beginner
mì [noodles]	Vietnamese-Beginner
táo [apple]	Vietnamese-Beginner
chuối [banana]	Vietnamese-Beginner
sữa [milk]	Vietnamese-Beginner
nước [water]	Vietnamese-Beginner
trà [tea]	Vietnamese-Beginner
cà phê [coffee]	Vietnamese-Beginner
trường học [school]	Vietnamese-Beginner
giáo viên [teacher]	Vietnamese-Beginner
học sinh [student]	Vietnamese-Beginner
sách [book]	Vietnamese-Beginner
bút [pen]	Vietnamese-Beginner
bàn [table]	Vietnamese-Beginner
ghế [chair]	Vietnamese-Beginner
nhà [home]	Vietnamese-Beginner
mẹ [mom]	Vietnamese-Beginner
bố [dad]	Vietnamese-Beginner
bạn bè [friend]	Vietnamese-Beginner
chó [dog]	Vietnamese-Beginner
mèo [cat]	Vietnamese-Beginner
xe [car]	Vietnamese-Beginner
tiền [money]	Vietnamese-Beginner
công việc [work]	Vietnamese-Beginner
ngủ [sleep]	Vietnamese-Beginner
đi bộ [walk]	Vietnamese-Beginner
đến [come]	Vietnamese-Beginner
đi [go]	Vietnamese-Beginner
thời tiết [weather]	Vietnamese-Beginner
hôm nay [today]	Vietnamese-Beginner
ngày mai [tomorrow]	Vietnamese-Beginner
giúp đỡ [help]	Vietnamese-Intermediate
nhớ [remember]	Vietnamese-Intermediate
quên [forget]	Vietnamese-Intermediate
hiểu [understand]	Vietnamese-Intermediate
luyện tập [practice]	Vietnamese-Intermediate
vấn đề [problem]	Vietnamese-Intermediate
câu trả lời [answer]	Vietnamese-Intermediate
siêu thị [supermarket]	Vietnamese-Intermediate
bệnh viện [hospital]	Vietnamese-Intermediate
ga tàu [train station]	Vietnamese-Intermediate
sân bay [airport]	Vietnamese-Intermediate
rạp chiếu phim [cinema]	Vietnamese-Intermediate
chúc mừng sinh nhật [happy birthday]	Vietnamese-Intermediate
không sao [no problem]	Vietnamese-Intermediate
tuyệt vời [great/awesome]	Vietnamese-Intermediate
thế nào [how is it]	Vietnamese-Intermediate
mấy giờ [what time]	Vietnamese-Intermediate
bao nhiêu tiền [how much]	Vietnamese-Intermediate
mở [open]	Vietnamese-Intermediate
đóng [close]	Vietnamese-Intermediate
tắm [take a shower]	Vietnamese-Intermediate
gọi điện [make a phone call]	Vietnamese-Intermediate
chụp ảnh [take a photo]	Vietnamese-Intermediate
chờ [wait]	Vietnamese-Intermediate
cẩn thận [be careful]	Vietnamese-Intermediate
thành công [success]	Vietnamese-Intermediate
thất bại [failure]	Vietnamese-Intermediate
nỗ lực [effort]	Vietnamese-Intermediate
giấc mơ [dream]	Vietnamese-Intermediate
kế hoạch [plan]	Vietnamese-Intermediate
dự báo thời tiết [weather forecast]	Vietnamese-Intermediate
đèn giao thông [traffic light]	Vietnamese-Intermediate
chứng minh thư [ID card]	Vietnamese-Intermediate
thẻ tín dụng [credit card]	Vietnamese-Intermediate
thực đơn [menu]	Vietnamese-Intermediate
nhân viên phục vụ [waiter]	Vietnamese-Intermediate
gợi ý [recommend]	Vietnamese-Intermediate
món ăn có ngon không [how does it taste]	Vietnamese-Intermediate
quá đắt [too expensive]	Vietnamese-Intermediate
giảm giá [discount]	Vietnamese-Intermediate
kỳ thi [exam]	Vietnamese-Intermediate
ôn tập [review]	Vietnamese-Intermediate
cải thiện [improve]	Vietnamese-Intermediate
phát âm [pronunciation]	Vietnamese-Intermediate
ngữ pháp [grammar]	Vietnamese-Intermediate
văn hóa [culture]	Vietnamese-Intermediate
lễ hội [holiday]	Vietnamese-Intermediate
Tết Nguyên Đán [Lunar New Year]	Vietnamese-Intermediate
Tết Trung Thu [Mid-Autumn Festival]	Vietnamese-Intermediate
Năm Rồng [Year of the Dragon]	Vietnamese-Intermediate
sức khỏe [health]	Vietnamese-Intermediate
hola [hello]	Spanish-Beginner
gracias [thank you]	Spanish-Beginner
adiós [goodbye]	Spanish-Beginner
por favor [please]	Spanish-Beginner
lo siento [sorry]	Spanish-Beginner
sí [yes]	Spanish-Beginner
no [no]	Spanish-Beginner
yo [I]	Spanish-Beginner
tú [you]	Spanish-Beginner
él [he]	Spanish-Beginner
ella [she]	Spanish-Beginner
nosotros [we]	Spanish-Beginner
ellos [they]	Spanish-Beginner
comer [eat]	Spanish-Beginner
beber [drink]	Spanish-Beginner
mirar [look/watch]	Spanish-Beginner
hablar [speak/say]	Spanish-Beginner
escuchar [listen]	Spanish-Beginner
gustar [like]	Spanish-Beginner
amar [love]	Spanish-Beginner
arroz [rice]	Spanish-Beginner
fideos [noodles]	Spanish-Beginner
manzana [apple]	Spanish-Beginner
plátano [banana]	Spanish-Beginner
leche [milk]	Spanish-Beginner
agua [water]	Spanish-Beginner
té [tea]	Spanish-Beginner
café [coffee]	Spanish-Beginner
escuela [school]	Spanish-Beginner
maestro [teacher]	Spanish-Beginner
estudiante [student]	Spanish-Beginner
libro [book]	Spanish-Beginner
lápiz [pen]	Spanish-Beginner
mesa [table]	Spanish-Beginner
silla [chair]	Spanish-Beginner
casa [home]	Spanish-Beginner
madre [mom]	Spanish-Beginner
padre [dad]	Spanish-Beginner
amigo [friend]	Spanish-Beginner
perro [dog]	Spanish-Beginner
gato [cat]	Spanish-Beginner
coche [car]	Spanish-Beginner
dinero [money]	Spanish-Beginner
trabajo [work]	Spanish-Beginner
dormir [sleep]	Spanish-Beginner
caminar [walk]	Spanish-Beginner
venir [come]	Spanish-Beginner
ir [go]	Spanish-Beginner
tiempo [weather]	Spanish-Beginner
hoy [today]	Spanish-Beginner
mañana [tomorrow]	Spanish-Beginner
ayudar [help]	Spanish-Intermediate
recordar [remember]	Spanish-Intermediate
olvidar [forget]	Spanish-Intermediate
entender [understand]	Spanish-Intermediate
practicar [practice]	Spanish-Intermediate
problema [problem]	Spanish-Intermediate
respuesta [answer]	Spanish-Intermediate
supermercado [supermarket]	Spanish-Intermediate
hospital [hospital]	Spanish-Intermediate
estación de tren [train station]	Spanish-Intermediate
aeropuerto [airport]	Spanish-Intermediate
cine [cinema]	Spanish-Intermediate
feliz cumpleaños [happy birthday]	Spanish-Intermediate
no hay problema [no problem]	Spanish-Intermediate
genial [great/awesome]	Spanish-Intermediate
¿cómo está? [how is it]	Spanish-Intermediate
¿qué hora es? [what time is it]	Spanish-Intermediate
¿cuánto cuesta? [how much]	Spanish-Intermediate
abrir [open]	Spanish-Intermediate
cerrar [close]	Spanish-Intermediate
ducharse [take a shower]	Spanish-Intermediate
llamar por teléfono [make a phone call]	Spanish-Intermediate
tomar foto [take a photo]	Spanish-Intermediate
esperar [wait]	Spanish-Intermediate
cuidado [be careful]	Spanish-Intermediate
éxito [success]	Spanish-Intermediate
fracaso [failure]	Spanish-Intermediate
esfuerzo [effort]	Spanish-Intermediate
sueño [dream]	Spanish-Intermediate
plan [plan]	Spanish-Intermediate
pronóstico del tiempo [weather forecast]	Spanish-Intermediate
semáforo [traffic light]	Spanish-Intermediate
documento de identidad [ID card]	Spanish-Intermediate
tarjeta de crédito [credit card]	Spanish-Intermediate
menú [menu]	Spanish-Intermediate
camarero [waiter]	Spanish-Intermediate
recomendar [recommend]	Spanish-Intermediate
¿qué tal el sabor? [how does it taste]	Spanish-Intermediate
demasiado caro [too expensive]	Spanish-Intermediate
descuento [discount]	Spanish-Intermediate
examen [exam]	Spanish-Intermediate
repasar [review]	Spanish-Intermediate
mejorar [improve]	Spanish-Intermediate
pronunciación [pronunciation]	Spanish-Intermediate
gramática [grammar]	Spanish-Intermediate
cultura [culture]	Spanish-Intermediate
fiesta [holiday]	Spanish-Intermediate
Año Nuevo [New Year]	Spanish-Intermediate
Día de Muertos [Day of the Dead]	Spanish-Intermediate
Año del Dragón [Year of the Dragon]	Spanish-Intermediate
salud [health]	Spanish-Intermediate
H₂O [water]	Chemistry - Easy
O₂ [oxygen]	Chemistry - Easy
NaCl [salt]	Chemistry - Easy
CO₂ [carbon dioxide]	Chemistry - Easy
Fe [iron]	Chemistry - Easy
Au [gold]	Chemistry - Easy
Ag [silver]	Chemistry - Easy
Cu [copper]	Chemistry - Easy
H [hydrogen]	Chemistry - Easy
He [helium]	Chemistry - Easy
N₂ [nitrogen]	Chemistry - Easy
C [carbon]	Chemistry - Easy
Pb [lead]	Chemistry - Easy
Hg [mercury]	Chemistry - Easy
Sn [tin]	Chemistry - Easy
Al [aluminum]	Chemistry - Easy
Ca [calcium]	Chemistry - Easy
K [potassium]	Chemistry - Easy
Na [sodium]	Chemistry - Easy
Cl [chlorine]	Chemistry - Easy
S [sulfur]	Chemistry - Easy
P [phosphorus]	Chemistry - Easy
Ne [neon]	Chemistry - Easy
Ar [argon]	Chemistry - Easy
Pt [platinum]	Chemistry - Easy
solid [state of matter]	Chemistry - Easy
liquid [state of matter]	Chemistry - Easy
gas [state of matter]	Chemistry - Easy
melting [phase change]	Chemistry - Easy
freezing [phase change]	Chemistry - Easy
evaporation [phase change]	Chemistry - Easy
condensation [phase change]	Chemistry - Easy
boiling [phase change]	Chemistry - Easy
atom [basic particle]	Chemistry - Easy
molecule [bonded atoms]	Chemistry - Easy
element [basic substance]	Chemistry - Easy
compound [chemical combination]	Chemistry - Easy
mixture [physical combination]	Chemistry - Easy
solution [homogeneous mixture]	Chemistry - Easy
proton [subatomic particle]	Chemistry - Easy
neutron [subatomic particle]	Chemistry - Easy
electron [subatomic particle]	Chemistry - Easy
nucleus [atom core]	Chemistry - Easy
periodic table [element organizer]	Chemistry - Easy
chemical reaction [change in matter]	Chemistry - Easy
rust [iron oxide]	Chemistry - Easy
photosynthesis [plant chemistry]	Chemistry - Easy
combustion [fire reaction]	Chemistry - Easy
acid [low pH substance]	Chemistry - Easy
base [high pH substance]	Chemistry - Easy
pH [acid-base scale]	Chemistry - Easy
neutral [neither acid nor base]	Chemistry - Easy
density [how compact matter is]	Chemistry - Easy
mass [measured in grams]	Chemistry - Easy
volume [measured in liters]	Chemistry - Easy
temperature [measured in degrees]	Chemistry - Easy
thermometer [lab instrument]	Chemistry - Easy
beaker [lab equipment]	Chemistry - Easy
test tube [lab equipment]	Chemistry - Easy
graduated cylinder [lab equipment]	Chemistry - Easy
goggles [lab safety]	Chemistry - Easy
lab coat [lab safety]	Chemistry - Easy
fire extinguisher [lab safety]	Chemistry - Easy
chemical formula [substance shorthand]	Chemistry - Easy
physical change [reversible change]	Chemistry - Easy
chemical change [irreversible change]	Chemistry - Easy
dissolving [going into solution]	Chemistry - Easy
filtration [separation method]	Chemistry - Easy
distillation [separation method]	Chemistry - Easy
metal [element type]	Chemistry - Easy
nonmetal [element type]	Chemistry - Easy
gas [matter state]	Chemistry - Easy
oxygen [O on periodic table]	Chemistry - Easy
carbon dioxide [CO₂]	Chemistry - Easy
baking soda [sodium bicarbonate]	Chemistry - Easy
vinegar [acetic acid]	Chemistry - Easy
hydrogen peroxide [H₂O₂]	Chemistry - Easy
ammonia [NH₃]	Chemistry - Easy
table sugar [sucrose]	Chemistry - Easy
stainless steel [iron alloy]	Chemistry - Easy
bronze [metal alloy]	Chemistry - Easy
brass [metal alloy]	Chemistry - Easy
diamond [carbon form]	Chemistry - Easy
graphite [carbon form]	Chemistry - Easy
litmus paper [pH test strip]	Chemistry - Easy
indicator [acid-base tester]	Chemistry - Easy
Bunsen burner [lab equipment]	Chemistry - Easy
flask [lab equipment]	Chemistry - Easy
magnet [magnetic material]	Chemistry - Easy
conductor [electrical property]	Chemistry - Easy
insulator [electrical property]	Chemistry - Easy
flammable [safety warning]	Chemistry - Easy
toxic [safety warning]	Chemistry - Easy
corrosive [safety warning]	Chemistry - Easy
conservation of mass [chemistry law]	Chemistry - Easy
reactant [before reaction]	Chemistry - Easy
product [after reaction]	Chemistry - Easy
catalyst [reaction helper]	Chemistry - Easy
energy [measured in joules]	Chemistry - Easy
exothermic [reaction type]	Chemistry - Easy
alkali metals [lithium sodium potassium]	Chemistry - Intermediate
alkaline earth metals [beryllium magnesium calcium]	Chemistry - Intermediate
halogens [fluorine chlorine bromine]	Chemistry - Intermediate
noble gases [helium neon argon]	Chemistry - Intermediate
transition metals [iron copper zinc]	Chemistry - Intermediate
metalloids [silicon germanium arsenic]	Chemistry - Intermediate
lanthanides [cerium europium gadolinium]	Chemistry - Intermediate
actinides [uranium plutonium thorium]	Chemistry - Intermediate
ionic bond [metal to nonmetal]	Chemistry - Intermediate
covalent bond [nonmetal to nonmetal]	Chemistry - Intermediate
metallic bond [metal to metal]	Chemistry - Intermediate
hydrogen bond [water cohesion]	Chemistry - Intermediate
van der Waals [London dispersion]	Chemistry - Intermediate
polar covalent [partial charges]	Chemistry - Intermediate
electronegativity [Pauling scale]	Chemistry - Intermediate
valence electrons [bonding electrons]	Chemistry - Intermediate
electron configuration [orbital filling order]	Chemistry - Intermediate
orbital [s p d f]	Chemistry - Intermediate
quantum numbers [n l ml ms]	Chemistry - Intermediate
Aufbau principle [orbital filling rule]	Chemistry - Intermediate
Hund\'s rule [parallel spin first]	Chemistry - Intermediate
Pauli exclusion [opposite spins only]	Chemistry - Intermediate
mole [Avogadro\'s number]	Chemistry - Intermediate
molar mass [molecular weight]	Chemistry - Intermediate
molarity [solution concentration]	Chemistry - Intermediate
stoichiometry [mole ratios]	Chemistry - Intermediate
limiting reagent [determines product amount]	Chemistry - Intermediate
excess reagent [not fully consumed]	Chemistry - Intermediate
percent yield [reaction efficiency]	Chemistry - Intermediate
empirical formula [reduced formula]	Chemistry - Intermediate
molecular formula [true formula]	Chemistry - Intermediate
Avogadro\'s number [6.022 × 10²³]	Chemistry - Intermediate
Arrhenius acid [proton donor]	Chemistry - Intermediate
Arrhenius base [hydroxide donor]	Chemistry - Intermediate
Brønsted-Lowry acid [H⁺ giver]	Chemistry - Intermediate
Brønsted-Lowry base [H⁺ receiver]	Chemistry - Intermediate
Lewis acid [empty orbital species]	Chemistry - Intermediate
Lewis base [lone pair species]	Chemistry - Intermediate
strong acid [HCl HNO₃ H₂SO₄]	Chemistry - Intermediate
weak acid [acetic acid HF]	Chemistry - Intermediate
buffer [weak acid plus salt]	Chemistry - Intermediate
titration [neutralization measurement]	Chemistry - Intermediate
equivalence point [neutralization complete]	Chemistry - Intermediate
pH scale [0 to 14 range]	Chemistry - Intermediate
organic chemistry [hydrocarbon based]	Chemistry - Intermediate
hydrocarbon [alkane alkene alkyne]	Chemistry - Intermediate
alkane [saturated hydrocarbon]	Chemistry - Intermediate
alkene [unsaturated hydrocarbon]	Chemistry - Intermediate
alkyne [unsaturated hydrocarbon]	Chemistry - Intermediate
functional group [determines properties]	Chemistry - Intermediate
alcohol [OH functional group]	Chemistry - Intermediate
carboxylic acid [organic acid]	Chemistry - Intermediate
ester [fruity smell compound]	Chemistry - Intermediate
amine [NH₂ functional group]	Chemistry - Intermediate
polymer [plastic and rubber]	Chemistry - Intermediate
monomer [polymer building block]	Chemistry - Intermediate
isomer [structural variation]	Chemistry - Intermediate
synthesis reaction [combination reaction]	Chemistry - Intermediate
decomposition reaction [breaking apart]	Chemistry - Intermediate
single replacement [substitution reaction]	Chemistry - Intermediate
double replacement [metathesis reaction]	Chemistry - Intermediate
combustion reaction [burning reaction]	Chemistry - Intermediate
redox reaction [oxidation-reduction]	Chemistry - Intermediate
oxidation [increase in charge]	Chemistry - Intermediate
reduction [decrease in charge]	Chemistry - Intermediate
oxidizing agent [causes oxidation]	Chemistry - Intermediate
reducing agent [causes reduction]	Chemistry - Intermediate
Boyle\'s law [P₁V₁ = P₂V₂]	Chemistry - Intermediate
Charles\'s law [V₁/T₁ = V₂/T₂]	Chemistry - Intermediate
Gay-Lussac\'s law [P₁/T₁ = P₂/T₂]	Chemistry - Intermediate
ideal gas law [PV = nRT]	Chemistry - Intermediate
Dalton\'s law [total pressure law]	Chemistry - Intermediate
STP [0°C and 1 atm]	Chemistry - Intermediate
equilibrium [dynamic balance]	Chemistry - Intermediate
Le Chatelier\'s principle [stress response]	Chemistry - Intermediate
equilibrium constant [Keq expression]	Chemistry - Intermediate
reaction rate [concentration per time]	Chemistry - Intermediate
activation energy [reaction energy barrier]	Chemistry - Intermediate
enthalpy [ΔH measurement]	Chemistry - Intermediate
exothermic reaction [releases heat]	Chemistry - Intermediate
endothermic reaction [absorbs heat]	Chemistry - Intermediate
entropy [ΔS value]	Chemistry - Intermediate
Gibbs free energy [ΔG = ΔH − TΔS]	Chemistry - Intermediate
calorimetry [q = mcΔT]	Chemistry - Intermediate
specific heat [heat capacity]	Chemistry - Intermediate
Hess\'s law [sum of steps]	Chemistry - Intermediate
sublimation [dry ice example]	Chemistry - Intermediate
deposition [frost formation]	Chemistry - Intermediate
colligative properties [boiling point elevation]	Chemistry - Intermediate
molality [concentration unit]	Chemistry - Intermediate
solubility [grams per liter]	Chemistry - Intermediate
saturated solution [at equilibrium]	Chemistry - Intermediate
precipitation reaction [solid from solution]	Chemistry - Intermediate
electrolyte [ionic compound]	Chemistry - Intermediate
nonelectrolyte [molecular compound]	Chemistry - Intermediate
half-life [radioactive decay rate]	Chemistry - Intermediate
nuclear fission [releases energy]	Chemistry - Intermediate
nuclear fusion [sun\'s energy source]	Chemistry - Intermediate
isotope [same element variant]	Chemistry - Intermediate
ion [cation or anion]	Chemistry - Intermediate
cell (smallest unit of life) [basic life unit]	Biology - Easy
nucleus (cell control center) [contains DNA]	Biology - Easy
cell membrane (cell outer barrier) [controls entry and exit]	Biology - Easy
cell wall (rigid plant cell layer) [plant cell support]	Biology - Easy
chloroplast (photosynthesis organelle) [makes food in plants]	Biology - Easy
mitochondria (cell energy maker) [powerhouse of cell]	Biology - Easy
cytoplasm (jelly-like cell filling) [holds organelles]	Biology - Easy
vacuole (cell storage bubble) [stores water and nutrients]	Biology - Easy
ribosome (protein making structure) [builds proteins]	Biology - Easy
photosynthesis (plants make glucose) [uses sunlight]	Biology - Easy
carbon dioxide (gas plants absorb) [CO₂]	Biology - Easy
oxygen (gas plants release) [O₂]	Biology - Easy
glucose (sugar plants produce) [energy molecule]	Biology - Easy
chlorophyll (green plant pigment) [absorbs sunlight]	Biology - Easy
root (absorbs water underground) [plant anchor]	Biology - Easy
stem (supports leaves and flowers) [plant transport]	Biology - Easy
leaf (where photosynthesis occurs) [food-making organ]	Biology - Easy
flower (plant reproductive structure) [makes seeds]	Biology - Easy
seed (contains baby plant) [plant embryo]	Biology - Easy
pollen (powdery plant fertilizer) [male plant cell]	Biology - Easy
pollination (pollen reaches flower) [bee-assisted transfer]	Biology - Easy
germination (seed begins growing) [sprouting process]	Biology - Easy
fruit (seed-containing structure) [protects seeds]	Biology - Easy
ecosystem (living and nonliving together) [community and environment]	Biology - Easy
habitat (where organism lives) [natural home]	Biology - Easy
food chain (energy transfer sequence) [who eats whom]	Biology - Easy
producer (makes own food) [plants and algae]	Biology - Easy
consumer (eats other organisms) [animals]	Biology - Easy
herbivore (eats only plants) [plant eater]	Biology - Easy
carnivore (eats only meat) [meat eater]	Biology - Easy
omnivore (eats plants and meat) [mixed diet]	Biology - Easy
decomposer (breaks down dead matter) [fungi and bacteria]	Biology - Easy
predator (hunts other animals) [hunter]	Biology - Easy
prey (hunted by predators) [food for predators]	Biology - Easy
food web (interconnected food chains) [complex energy flow]	Biology - Easy
vertebrate (animal with backbone) [fish birds mammals]	Biology - Easy
invertebrate (animal without backbone) [insects worms jellyfish]	Biology - Easy
mammal (warm-blooded with fur) [nurses young with milk]	Biology - Easy
reptile (cold-blooded with scales) [lizards snakes turtles]	Biology - Easy
amphibian (lives on land and water) [frogs salamanders]	Biology - Easy
fish (aquatic with gills) [breathes underwater]	Biology - Easy
bird (feathered warm-blooded animal) [lays hard eggs]	Biology - Easy
insect (six-legged arthropod) [ants bees butterflies]	Biology - Easy
arachnid (eight-legged arthropod) [spiders scorpions ticks]	Biology - Easy
heart (pumps blood organ) [circulatory system]	Biology - Easy
lungs (breathing organs) [respiratory system]	Biology - Easy
brain (thinking organ) [nervous system control]	Biology - Easy
stomach (digests food organ) [digestive system]	Biology - Easy
skeleton (bone framework) [supports body]	Biology - Easy
muscle (body movement tissue) [contracts and relaxes]	Biology - Easy
skin (body outer covering) [largest organ]	Biology - Easy
blood (carries oxygen through body) [red liquid]	Biology - Easy
bones (hard body framework) [206 in adult body]	Biology - Easy
teeth (chewing structures) [breaks down food]	Biology - Easy
tongue (taste sensing organ) [five taste types]	Biology - Easy
eyes (sight organs) [detect light]	Biology - Easy
ears (hearing organs) [detect sound]	Biology - Easy
nose (smell organ) [detects odors]	Biology - Easy
life cycle (birth to death stages) [organism development]	Biology - Easy
metamorphosis (dramatic body change) [caterpillar to butterfly]	Biology - Easy
larva (immature insect stage) [caterpillar or grub]	Biology - Easy
pupa (resting transformation stage) [chrysalis or cocoon]	Biology - Easy
tadpole (immature frog stage) [has tail and gills]	Biology - Easy
migration (seasonal animal movement) [birds fly south]	Biology - Easy
hibernation (winter deep sleep) [bears do this]	Biology - Easy
camouflage (blending with surroundings) [survival strategy]	Biology - Easy
adaptation (trait for survival) [fits environment]	Biology - Easy
endangered (at risk of extinction) [few left alive]	Biology - Easy
extinct (no longer exists) [dinosaurs are this]	Biology - Easy
species (group of similar organisms) [can reproduce together]	Biology - Easy
population (same species in area) [group count]	Biology - Easy
community (different species together) [living things in area]	Biology - Easy
biome (large ecosystem type) [desert forest tundra]	Biology - Easy
desert (hot dry biome) [little rainfall]	Biology - Easy
rainforest (warm wet dense biome) [most biodiversity]	Biology - Easy
ocean (saltwater biome) [largest ecosystem]	Biology - Easy
tundra (cold treeless biome) [frozen ground]	Biology - Easy
wetland (water-saturated land) [swamps and marshes]	Biology - Easy
freshwater (not salty water) [rivers lakes ponds]	Biology - Easy
bacteria (microscopic single-celled organism) [can be helpful]	Biology - Easy
virus (tiny infectious particle) [causes colds and flu]	Biology - Easy
fungi (decomposing organisms) [mushrooms and mold]	Biology - Easy
nutrition (food for body needs) [vitamins and minerals]	Biology - Easy
protein (body building nutrient) [meat beans eggs]	Biology - Easy
carbohydrate (energy giving nutrient) [bread rice pasta]	Biology - Easy
fat (stored energy nutrient) [butter oil nuts]	Biology - Easy
vitamin (essential body nutrient) [A B C D]	Biology - Easy
mineral (inorganic body nutrient) [calcium iron zinc]	Biology - Easy
water cycle (evaporation and rain) [hydrological cycle]	Biology - Easy
evaporation (water to vapor) [sun heats water]	Biology - Easy
precipitation (water falls from clouds) [rain snow hail]	Biology - Easy
condensation (vapor becomes liquid) [cloud formation]	Biology - Easy
respiration (cells release energy) [uses oxygen]	Biology - Easy
warm-blooded (constant body temperature) [mammals and birds]	Biology - Easy
cold-blooded (variable body temperature) [reptiles and fish]	Biology - Easy
nocturnal (active at night) [owls and bats]	Biology - Easy
diurnal (active during day) [humans and dogs]	Biology - Easy
herbivore (plant-eating animal) [rabbit deer cow]	Biology - Easy
oxygen (gas animals breathe in) [needed for survival]	Biology - Easy
carbon dioxide (gas animals breathe out) [waste gas]	Biology - Easy
DNA (deoxyribonucleic acid) [genetic blueprint]	Biology - Intermediate
RNA (ribonucleic acid) [protein synthesis messenger]	Biology - Intermediate
gene (DNA segment for trait) [unit of heredity]	Biology - Intermediate
chromosome (DNA package structure) [23 pairs in humans]	Biology - Intermediate
allele (gene variant form) [dominant or recessive]	Biology - Intermediate
dominant allele (expressed over recessive) [uppercase letter]	Biology - Intermediate
recessive allele (masked by dominant) [lowercase letter]	Biology - Intermediate
genotype (genetic makeup letters) [AA Aa aa]	Biology - Intermediate
phenotype (observable trait expression) [physical appearance]	Biology - Intermediate
heterozygous (two different alleles) [Aa carrier]	Biology - Intermediate
homozygous (two same alleles) [AA or aa]	Biology - Intermediate
Punnett square (cross prediction grid) [genetics tool]	Biology - Intermediate
Mendel (father of genetics) [pea plant experiments]	Biology - Intermediate
mutation (DNA sequence change) [source of variation]	Biology - Intermediate
heredity (trait inheritance process) [parents to offspring]	Biology - Intermediate
mitosis (cell division for growth) [produces identical cells]	Biology - Intermediate
meiosis (cell division for gametes) [produces sex cells]	Biology - Intermediate
cytokinesis (cytoplasm division) [cell splitting apart]	Biology - Intermediate
interphase (cell growth phase) [DNA replication occurs]	Biology - Intermediate
prophase (chromosomes condense phase) [spindle forms]	Biology - Intermediate
metaphase (chromosomes align middle) [equatorial plate]	Biology - Intermediate
anaphase (chromosomes separate phase) [pulled to poles]	Biology - Intermediate
telophase (nuclear envelope reforms) [division nearly complete]	Biology - Intermediate
gamete (reproductive sex cell) [sperm or egg]	Biology - Intermediate
zygote (fertilized egg cell) [first cell of organism]	Biology - Intermediate
diploid (two chromosome sets) [body cells 2n]	Biology - Intermediate
haploid (one chromosome set) [sex cells n]	Biology - Intermediate
crossing over (chromosome segment exchange) [genetic recombination]	Biology - Intermediate
natural selection (survival of fittest) [Darwin\'s theory]	Biology - Intermediate
evolution (species change over time) [adaptation accumulation]	Biology - Intermediate
adaptation (evolved survival trait) [fitness advantage]	Biology - Intermediate
speciation (new species formation) [reproductive isolation]	Biology - Intermediate
fossil record (preserved organism evidence) [evolution proof]	Biology - Intermediate
homologous structures (similar anatomy different function) [common ancestor]	Biology - Intermediate
vestigial structures (reduced useless organs) [evolutionary remnants]	Biology - Intermediate
taxonomy (organism classification science) [naming and grouping]	Biology - Intermediate
binomial nomenclature (two-part species name) [genus and species]	Biology - Intermediate
kingdom (highest classification level) [animal plant fungi]	Biology - Intermediate
phylum (second classification level) [body plan group]	Biology - Intermediate
class (third classification level) [mammalia reptilia]	Biology - Intermediate
order (fourth classification level) [primates carnivora]	Biology - Intermediate
family (fifth classification level) [related genera]	Biology - Intermediate
genus (sixth classification level) [closely related species]	Biology - Intermediate
species (most specific classification) [can interbreed]	Biology - Intermediate
ecology (organism environment study) [interactions science]	Biology - Intermediate
biotic factor (living ecosystem part) [plants animals fungi]	Biology - Intermediate
abiotic factor (nonliving ecosystem part) [water sunlight soil]	Biology - Intermediate
symbiosis (close species relationship) [living together]	Biology - Intermediate
mutualism (both species benefit) [clownfish and anemone]	Biology - Intermediate
parasitism (one benefits one harmed) [tick on dog]	Biology - Intermediate
commensalism (one benefits one unaffected) [barnacle on whale]	Biology - Intermediate
competition (organisms rival for resources) [same niche struggle]	Biology - Intermediate
niche (organism\'s ecological role) [job in ecosystem]	Biology - Intermediate
succession (ecosystem change over time) [community replacement]	Biology - Intermediate
carrying capacity (maximum population supported) [resource limit]	Biology - Intermediate
trophic level (feeding position level) [energy pyramid step]	Biology - Intermediate
biomass (total living matter mass) [organic material weight]	Biology - Intermediate
endoplasmic reticulum (membrane transport network) [smooth and rough]	Biology - Intermediate
Golgi apparatus (protein packaging organelle) [shipping department]	Biology - Intermediate
lysosome (digestive enzyme organelle) [cell cleanup crew]	Biology - Intermediate
ATP (adenosine triphosphate) [energy currency]	Biology - Intermediate
cellular respiration (glucose to ATP) [C₆H₁₂O₆ + O₂]	Biology - Intermediate
glycolysis (glucose splitting process) [first respiration step]	Biology - Intermediate
Krebs cycle (citric acid cycle) [second respiration step]	Biology - Intermediate
electron transport chain (ATP production stage) [most ATP made]	Biology - Intermediate
fermentation (anaerobic energy release) [without oxygen]	Biology - Intermediate
enzyme (biological reaction catalyst) [protein catalyst]	Biology - Intermediate
substrate (enzyme target molecule) [lock and key fit]	Biology - Intermediate
active site (enzyme binding region) [substrate fits here]	Biology - Intermediate
protein (amino acid polymer) [folded polypeptide]	Biology - Intermediate
amino acid (protein building block) [20 types exist]	Biology - Intermediate
lipid (fat and oil molecule) [energy storage molecule]	Biology - Intermediate
carbohydrate (sugar and starch molecule) [quick energy source]	Biology - Intermediate
nucleotide (DNA building block) [base sugar phosphate]	Biology - Intermediate
codon (three-base RNA sequence) [codes for amino acid]	Biology - Intermediate
transcription (DNA to mRNA process) [occurs in nucleus]	Biology - Intermediate
translation (mRNA to protein process) [occurs at ribosome]	Biology - Intermediate
replication (DNA copying process) [semiconservative method]	Biology - Intermediate
homeostasis (internal balance maintenance) [stable internal environment]	Biology - Intermediate
negative feedback (reverses change direction) [thermostat example]	Biology - Intermediate
positive feedback (amplifies change direction) [blood clotting example]	Biology - Intermediate
hormone (chemical messenger molecule) [endocrine system signal]	Biology - Intermediate
neuron (nerve signal cell) [brain and nerve cell]	Biology - Intermediate
synapse (nerve cell junction) [signal crossing gap]	Biology - Intermediate
immune system (body defense network) [fights pathogens]	Biology - Intermediate
antibody (pathogen targeting protein) [immune response molecule]	Biology - Intermediate
antigen (immune triggering molecule) [foreign substance marker]	Biology - Intermediate
vaccine (weakened pathogen preparation) [builds immunity]	Biology - Intermediate
pathogen (disease causing organism) [bacteria virus parasite]	Biology - Intermediate
antibiotic (kills bacteria medicine) [penicillin example]	Biology - Intermediate
mitochondrial DNA (maternal genetic material) [inherited from mother]	Biology - Intermediate
stem cell (unspecialized dividing cell) [can become any cell]	Biology - Intermediate
cancer (uncontrolled cell division) [tumor formation]	Biology - Intermediate
genetic engineering (DNA manipulation technology) [gene editing]	Biology - Intermediate
GMO (genetically modified organism) [altered DNA organism]	Biology - Intermediate
cloning (identical genetic copy) [Dolly the sheep]	Biology - Intermediate
gel electrophoresis (DNA separation technique) [size-based sorting]	Biology - Intermediate
PCR (DNA amplification technique) [polymerase chain reaction]	Biology - Intermediate
plasmid (bacterial circular DNA) [gene transfer vector]	Biology - Intermediate
biodiversity (variety of life forms) [species richness]	Biology - Intermediate
George Washington (first president) [father of country]	US History - Easy
Abraham Lincoln (16th president) [freed the slaves]	US History - Easy
Thomas Jefferson (wrote famous document) [Declaration of Independence]	US History - Easy
Benjamin Franklin (inventor and diplomat) [founding father]	US History - Easy
John Adams (second president) [first vice president]	US History - Easy
James Madison (father of document) [Constitution author]	US History - Easy
Alexander Hamilton (first treasury secretary) [financial system creator]	US History - Easy
Paul Revere (midnight ride warning) [the British are coming]	US History - Easy
Betsy Ross (flag maker legend) [first American flag]	US History - Easy
Pocahontas (helped Jamestown settlers) [Native American peacemaker]	US History - Easy
Declaration of Independence (freedom document year) [1776]	US History - Easy
Constitution (supreme law document) [We the People]	US History - Easy
Bill of Rights (first ten amendments) [protects freedoms]	US History - Easy
Emancipation Proclamation (freed enslaved people) [Abraham Lincoln 1863]	US History - Easy
Gettysburg Address (famous Civil War speech) [Abraham Lincoln]	US History - Easy
Mayflower (Pilgrim ship name) [sailed to Plymouth]	US History - Easy
Plymouth Rock (Pilgrim landing spot) [Massachusetts 1620]	US History - Easy
Jamestown (first permanent settlement) [Virginia 1607]	US History - Easy
Boston Tea Party (tax protest event) [threw tea overboard]	US History - Easy
Revolutionary War (independence from Britain) [1775 to 1783]	US History - Easy
Civil War (North versus South) [1861 to 1865]	US History - Easy
World War I (first global conflict) [1914 to 1918]	US History - Easy
World War II (second global conflict) [1939 to 1945]	US History - Easy
Pearl Harbor (Japan attacked Hawaii) [December 7 1941]	US History - Easy
D-Day (Allied invasion of France) [June 6 1944]	US History - Easy
Martin Luther King Jr. (civil rights leader) [I Have a Dream]	US History - Easy
Rosa Parks (refused to move seats) [bus boycott hero]	US History - Easy
Harriet Tubman (Underground Railroad conductor) [freed enslaved people]	US History - Easy
Frederick Douglass (abolitionist speaker and writer) [former enslaved person]	US History - Easy
Susan B. Anthony (fought for women\'s vote) [suffrage leader]	US History - Easy
Statue of Liberty (gift from France) [symbol of freedom]	US History - Easy
Liberty Bell (cracked freedom symbol) [Philadelphia landmark]	US History - Easy
Mount Rushmore (four presidents carved) [South Dakota monument]	US History - Easy
White House (president\'s home) [Washington DC]	US History - Easy
Capitol Building (Congress meets here) [Washington DC landmark]	US History - Easy
Washington Monument (tall white obelisk) [DC landmark]	US History - Easy
Lincoln Memorial (seated president statue) [DC memorial]	US History - Easy
Thanksgiving (harvest celebration holiday) [Pilgrims and Natives]	US History - Easy
Independence Day (birthday of America) [July Fourth]	US History - Easy
Memorial Day (honors fallen soldiers) [last Monday in May]	US History - Easy
Veterans Day (honors all who served) [November eleventh]	US History - Easy
Presidents Day (honors US presidents) [February holiday]	US History - Easy
Columbus Day (explorer arrival day) [October holiday]	US History - Easy
Christopher Columbus (sailed to Americas) [1492 voyage]	US History - Easy
Lewis and Clark (explored the West) [Corps of Discovery]	US History - Easy
Louisiana Purchase (doubled US size) [bought from France 1803]	US History - Easy
Gold Rush (California mining rush) [1849 forty-niners]	US History - Easy
Oregon Trail (westward wagon route) [pioneer pathway]	US History - Easy
Transcontinental Railroad (coast to coast train) [completed 1869]	US History - Easy
Thomas Edison (light bulb inventor) [Menlo Park genius]	US History - Easy
Alexander Graham Bell (telephone inventor) [first phone call]	US History - Easy
Wright Brothers (first airplane flight) [Kitty Hawk 1903]	US History - Easy
Henry Ford (Model T car maker) [assembly line pioneer]	US History - Easy
Neil Armstrong (first moon walker) [one small step]	US History - Easy
Amelia Earhart (famous female pilot) [disappeared over Pacific]	US History - Easy
Teddy Roosevelt (26th president) [teddy bear namesake]	US History - Easy
Franklin Roosevelt (32nd president) [New Deal leader]	US History - Easy
John F. Kennedy (35th president) [ask not speech]	US History - Easy
Barack Obama (44th president) [first African American president]	US History - Easy
Ulysses S. Grant (Civil War general) [18th president]	US History - Easy
Robert E. Lee (Confederate general) [surrendered at Appomattox]	US History - Easy
Sacagawea (Lewis and Clark guide) [Shoshone interpreter]	US History - Easy
Sojourner Truth (abolitionist and activist) [Ain\'t I a Woman]	US History - Easy
First Amendment (protects free speech) [freedom of religion]	US History - Easy
Second Amendment (right to bear arms) [gun rights]	US History - Easy
Thirteenth Amendment (abolished slavery) [ratified 1865]	US History - Easy
Nineteenth Amendment (women\'s right to vote) [ratified 1920]	US History - Easy
Electoral College (elects the president) [voting system]	US History - Easy
Congress (Senate and House combined) [legislative branch]	US History - Easy
Supreme Court (highest court in US) [judicial branch]	US History - Easy
President (head of government) [executive branch]	US History - Easy
three branches (legislative executive judicial) [separation of powers]	US History - Easy
democracy (government by the people) [citizen voting]	US History - Easy
amendment (change to Constitution) [27 total amendments]	US History - Easy
Pledge of Allegiance (patriotic daily recitation) [I pledge allegiance]	US History - Easy
Star-Spangled Banner (national anthem name) [Francis Scott Key]	US History - Easy
American flag (stars and stripes) [red white and blue]	US History - Easy
bald eagle (national bird symbol) [American symbol]	US History - Easy
Uncle Sam (US government symbol) [I Want You poster]	US History - Easy
Alamo (famous Texas battle) [Remember the Alamo]	US History - Easy
Trail of Tears (forced Native removal) [Cherokee relocation]	US History - Easy
Underground Railroad (secret escape network) [to freedom in North]	US History - Easy
Manifest Destiny (westward expansion belief) [coast to coast]	US History - Easy
Civil Rights Act (banned discrimination law) [signed 1964]	US History - Easy
Moon Landing (Apollo 11 mission) [July 20 1969]	US History - Easy
Great Depression (worst economic crisis) [started 1929]	US History - Easy
New Deal (FDR\'s recovery programs) [Depression relief]	US History - Easy
Cold War (US versus Soviet tension) [nuclear arms race]	US History - Easy
Thirteen Colonies (original British settlements) [became first states]	US History - Easy
Boston Massacre (British soldiers shot colonists) [1770 incident]	US History - Easy
Minutemen (ready in sixty seconds) [colonial militia]	US History - Easy
Valley Forge (harsh winter camp) [Continental Army 1777]	US History - Easy
John Hancock (large signature signer) [Declaration first signer]	US History - Easy
Patrick Henry (give me liberty speech) [Virginia patriot]	US History - Easy
Eli Whitney (cotton gin inventor) [changed Southern farming]	US History - Easy
Samuel Morse (telegraph inventor) [Morse code creator]	US History - Easy
Dwight Eisenhower (WWII general and president) [34th president]	US History - Easy
Harry Truman (ended WWII president) [33rd president]	US History - Easy
Ellis Island (immigrant entry point) [New York Harbor]	US History - Easy
Homestead Act (free western land law) [signed 1862]	US History - Easy
Marbury v. Madison (Supreme Court case) [judicial review]	US History - Intermediate
McCulloch v. Maryland (federal vs state power) [implied powers]	US History - Intermediate
Dred Scott v. Sandford (slavery case) [not citizens]	US History - Intermediate
Plessy v. Ferguson (segregation case) [separate but equal]	US History - Intermediate
Brown v. Board (school segregation) [unconstitutional]	US History - Intermediate
Roe v. Wade (privacy rights case) [abortion legalized]	US History - Intermediate
Miranda v. Arizona (arrest rights) [right to silence]	US History - Intermediate
Gideon v. Wainwright (criminal defense) [right to attorney]	US History - Intermediate
Gibbons v. Ogden (trade dispute) [interstate commerce]	US History - Intermediate
Citizens United (campaign finance) [corporate spending]	US History - Intermediate
1st Amendment (Bill of Rights) [freedom of speech]	US History - Intermediate
2nd Amendment (Bill of Rights) [right to bear arms]	US History - Intermediate
4th Amendment (Bill of Rights) [search and seizure]	US History - Intermediate
5th Amendment (Bill of Rights) [due process]	US History - Intermediate
13th Amendment (Civil War era) [abolished slavery]	US History - Intermediate
14th Amendment (Civil War era) [equal protection]	US History - Intermediate
15th Amendment (Civil War era) [voting rights race]	US History - Intermediate
19th Amendment (women's suffrage) [women can vote]	US History - Intermediate
18th Amendment (temperance movement) [prohibition]	US History - Intermediate
21st Amendment (repealed prohibition) [alcohol legal again]	US History - Intermediate
22nd Amendment (presidential term) [two term limit]	US History - Intermediate
26th Amendment (Vietnam era) [voting age eighteen]	US History - Intermediate
Reconstruction (post-Civil War) [rebuilding the South]	US History - Intermediate
Freedmen's Bureau (Reconstruction agency) [aid former slaves]	US History - Intermediate
Jim Crow Laws (post-Reconstruction) [racial segregation]	US History - Intermediate
Sharecropping (post-Civil War labor) [tenant farming]	US History - Intermediate
Black Codes (Southern legislation) [restrict Black rights]	US History - Intermediate
Compromise of 1877 (disputed election) [ended Reconstruction]	US History - Intermediate
Manifest Destiny (expansion belief) [westward expansion]	US History - Intermediate
Monroe Doctrine (foreign policy) [no European colonies]	US History - Intermediate
Roosevelt Corollary (to Monroe Doctrine) [US police power]	US History - Intermediate
Sherman Antitrust Act (Progressive Era) [break up monopolies]	US History - Intermediate
Clayton Antitrust Act (trust regulation) [strengthened Sherman Act]	US History - Intermediate
Interstate Commerce Act (railroad regulation) [regulate railroads]	US History - Intermediate
Pure Food and Drug Act (consumer protection) [food safety]	US History - Intermediate
Muckrakers (Progressive journalists) [exposed corruption]	US History - Intermediate
Upton Sinclair (wrote The Jungle) [meatpacking reform]	US History - Intermediate
Jane Addams (social reformer) [Hull House]	US History - Intermediate
Susan B. Anthony (suffrage leader) [women's voting rights]	US History - Intermediate
W.E.B. Du Bois (civil rights leader) [founded NAACP]	US History - Intermediate
Booker T. Washington (educator) [vocational education]	US History - Intermediate
Treaty of Versailles (ended WWI) [punished Germany]	US History - Intermediate
League of Nations (post-WWI group) [international peace]	US History - Intermediate
Lusitania (ship sunk by Germany) [US entered WWI]	US History - Intermediate
Zimmermann Telegram (WWI intercepted message) [Mexico alliance plot]	US History - Intermediate
Pearl Harbor (Japanese attack) [US entered WWII]	US History - Intermediate
D-Day (WWII invasion) [Normandy landing]	US History - Intermediate
Manhattan Project (WWII secret program) [atomic bomb]	US History - Intermediate
Hiroshima (WWII bombing) [first atomic bomb used]	US History - Intermediate
GI Bill (post-WWII law) [veteran benefits]	US History - Intermediate
Marshall Plan (post-WWII aid) [rebuild Europe]	US History - Intermediate
Truman Doctrine (Cold War policy) [contain communism]	US History - Intermediate
NATO (Cold War alliance) [Western military alliance]	US History - Intermediate
Warsaw Pact (Cold War alliance) [Soviet military alliance]	US History - Intermediate
Korean War (Cold War conflict) [divided Korea]	US History - Intermediate
Bay of Pigs (Cuba invasion) [failed CIA operation]	US History - Intermediate
Cuban Missile Crisis (nuclear standoff) [Soviet missiles removed]	US History - Intermediate
Gulf of Tonkin (Vietnam incident) [escalated Vietnam War]	US History - Intermediate
Tet Offensive (Vietnam War) [turning point]	US History - Intermediate
War Powers Act (post-Vietnam law) [limit presidential power]	US History - Intermediate
Domino Theory (Cold War belief) [communism spreads]	US History - Intermediate
Berlin Wall (Cold War symbol) [divided Germany]	US History - Intermediate
Iron Curtain (Cold War term) [East-West divide]	US History - Intermediate
McCarthyism (Red Scare era) [anti-communist witch hunts]	US History - Intermediate
Brown v. Board (desegregation ruling) [end school segregation]	US History - Intermediate
Rosa Parks (Montgomery Bus Boycott) [refused to move]	US History - Intermediate
Martin Luther King Jr. (civil rights leader) [nonviolent protest]	US History - Intermediate
March on Washington (1963 rally) [I Have a Dream]	US History - Intermediate
Civil Rights Act of 1964 (landmark law) [banned discrimination]	US History - Intermediate
Voting Rights Act (1965 law) [protected minority voting]	US History - Intermediate
Malcolm X (civil rights figure) [Black nationalism]	US History - Intermediate
Freedom Riders (civil rights activists) [desegregate buses]	US History - Intermediate
Little Rock Nine (school integration) [Arkansas desegregation]	US History - Intermediate
Sit-ins (civil rights tactic) [nonviolent protest]	US History - Intermediate
New Deal (FDR's programs) [Great Depression relief]	US History - Intermediate
Social Security Act (New Deal program) [retirement benefits]	US History - Intermediate
Tennessee Valley Authority (New Deal agency) [rural electricity]	US History - Intermediate
Great Society (LBJ's programs) [war on poverty]	US History - Intermediate
Medicare (Great Society program) [elderly healthcare]	US History - Intermediate
Medicaid (Great Society program) [low-income healthcare]	US History - Intermediate
Watergate (Nixon scandal) [presidential resignation]	US History - Intermediate
Pentagon Papers (Vietnam secrets) [government deception]	US History - Intermediate
Iran-Contra Affair (Reagan scandal) [secret arms deal]	US History - Intermediate
Camp David Accords (peace agreement) [Egypt-Israel peace]	US History - Intermediate
NAFTA (trade agreement) [free trade North America]	US History - Intermediate
Emancipation Proclamation (Lincoln's order) [freed slaves]	US History - Intermediate
Gettysburg Address (Lincoln's speech) [national unity]	US History - Intermediate
Seneca Falls Convention (1848 meeting) [women's rights]	US History - Intermediate
Trail of Tears (Native American removal) [forced relocation]	US History - Intermediate
Louisiana Purchase (1803 land deal) [doubled US size]	US History - Intermediate
Homestead Act (1862 law) [free western land]	US History - Intermediate
Dawes Act (Native American policy) [tribal land division]	US History - Intermediate
Chinese Exclusion Act (immigration law) [banned Chinese workers]	US History - Intermediate
Immigration Act of 1924 (quota system) [restricted immigration]	US History - Intermediate
Espionage Act (WWI law) [punish war opposition]	US History - Intermediate
Alien and Sedition Acts (1798 laws) [limit free speech]	US History - Intermediate
Federalist Papers (founding documents) [support Constitution]	US History - Intermediate
Electoral College (election system) [indirect voting]	US History - Intermediate
Checks and Balances (government design) [limit power]	US History - Intermediate
Filibuster (Senate tactic) [delay legislation]	US History - Intermediate
Heart (pumps blood) [circulatory system]	Anatomy - Easy
Brain (controls the body) [nervous system]	Anatomy - Easy
Lungs (help you breathe) [respiratory system]	Anatomy - Easy
Stomach (breaks down food) [digestive system]	Anatomy - Easy
Liver (cleans the blood) [largest internal organ]	Anatomy - Easy
Kidneys (filter waste) [make urine]	Anatomy - Easy
Skin (covers your body) [largest organ]	Anatomy - Easy
Skull (protects the brain) [head bone]	Anatomy - Easy
Spine (supports your back) [backbone]	Anatomy - Easy
Ribs (protect your chest) [rib cage]	Anatomy - Easy
Femur (upper leg bone) [longest bone]	Anatomy - Easy
Humerus (upper arm bone) [funny bone area]	Anatomy - Easy
Patella (front of knee) [kneecap]	Anatomy - Easy
Pelvis (supports your hips) [hip bone]	Anatomy - Easy
Clavicle (connects arm to body) [collarbone]	Anatomy - Easy
Scapula (back of shoulder) [shoulder blade]	Anatomy - Easy
Sternum (front of chest) [breastbone]	Anatomy - Easy
Tibia (lower leg bone) [shinbone]	Anatomy - Easy
Fibula (beside the tibia) [calf bone]	Anatomy - Easy
Radius (forearm bone) [thumb side]	Anatomy - Easy
Biceps (front of upper arm) [bends elbow]	Anatomy - Easy
Triceps (back of upper arm) [straightens elbow]	Anatomy - Easy
Quadriceps (front of thigh) [extends knee]	Anatomy - Easy
Hamstrings (back of thigh) [bends knee]	Anatomy - Easy
Abdominals (front of belly) [core muscles]	Anatomy - Easy
Diaphragm (below the lungs) [breathing muscle]	Anatomy - Easy
Tongue (inside the mouth) [taste and speech]	Anatomy - Easy
Teeth (used for chewing) [break down food]	Anatomy - Easy
Esophagus (food tube) [throat to stomach]	Anatomy - Easy
Small Intestine (after stomach) [absorbs nutrients]	Anatomy - Easy
Large Intestine (end of digestion) [absorbs water]	Anatomy - Easy
Appendix (near large intestine) [vestigial organ]	Anatomy - Easy
Gallbladder (stores bile) [helps digest fat]	Anatomy - Easy
Pancreas (near the stomach) [makes insulin]	Anatomy - Easy
Trachea (air passage) [windpipe]	Anatomy - Easy
Bronchi (branches in lungs) [airway tubes]	Anatomy - Easy
Nostrils (openings in nose) [breathe in air]	Anatomy - Easy
Larynx (in the throat) [voice box]	Anatomy - Easy
Eyelid (covers the eye) [protects eye]	Anatomy - Easy
Pupil (center of eye) [lets in light]	Anatomy - Easy
Iris (colored part of eye) [controls pupil size]	Anatomy - Easy
Retina (back of eye) [detects light]	Anatomy - Easy
Cornea (front of eye) [clear covering]	Anatomy - Easy
Eardrum (inside the ear) [vibrates with sound]	Anatomy - Easy
Cochlea (inner ear part) [hearing organ]	Anatomy - Easy
Red Blood Cells (in the blood) [carry oxygen]	Anatomy - Easy
White Blood Cells (in the blood) [fight infection]	Anatomy - Easy
Platelets (in the blood) [help clotting]	Anatomy - Easy
Plasma (liquid in blood) [carries blood cells]	Anatomy - Easy
Arteries (blood vessels) [carry blood away]	Anatomy - Easy
Veins (blood vessels) [return blood to heart]	Anatomy - Easy
Capillaries (tiny vessels) [exchange nutrients]	Anatomy - Easy
Aorta (largest artery) [leaves the heart]	Anatomy - Easy
Spleen (near the stomach) [filters blood]	Anatomy - Easy
Tonsils (back of throat) [fight germs]	Anatomy - Easy
Thyroid (in the neck) [controls metabolism]	Anatomy - Easy
Adrenal Glands (above kidneys) [stress hormones]	Anatomy - Easy
Pituitary Gland (base of brain) [master gland]	Anatomy - Easy
Spinal Cord (inside spine) [carries signals]	Anatomy - Easy
Nerves (throughout body) [send messages]	Anatomy - Easy
Cerebrum (top of brain) [thinking and memory]	Anatomy - Easy
Cerebellum (back of brain) [balance and movement]	Anatomy - Easy
Brain Stem (base of brain) [basic functions]	Anatomy - Easy
Taste Buds (on the tongue) [detect flavors]	Anatomy - Easy
Olfactory Nerve (in the nose) [sense of smell]	Anatomy - Easy
Hair Follicle (in the skin) [grows hair]	Anatomy - Easy
Sweat Glands (in the skin) [cool the body]	Anatomy - Easy
Epidermis (outer skin layer) [top layer of skin]	Anatomy - Easy
Dermis (under epidermis) [second skin layer]	Anatomy - Easy
Nails (on fingers and toes) [made of keratin]	Anatomy - Easy
Ligaments (connect bones) [hold joints together]	Anatomy - Easy
Tendons (connect muscle to bone) [help movement]	Anatomy - Easy
Cartilage (flexible tissue) [cushions joints]	Anatomy - Easy
Joints (where bones meet) [allow movement]	Anatomy - Easy
Molars (back teeth) [grinding food]	Anatomy - Easy
Canines (pointed teeth) [tearing food]	Anatomy - Easy
Incisors (front teeth) [cutting food]	Anatomy - Easy
Saliva (in the mouth) [starts digestion]	Anatomy - Easy
Bladder (stores liquid waste) [holds urine]	Anatomy - Easy
Ureters (tubes to bladder) [carry urine]	Anatomy - Easy
Urethra (exit tube) [releases urine]	Anatomy - Easy
Vocal Cords (in the larynx) [produce sound]	Anatomy - Easy
Enamel (covers teeth) [hardest body substance]	Anatomy - Easy
Marrow (inside bones) [makes blood cells]	Anatomy - Easy
Oxygen (breathed in air) [cells need it]	Anatomy - Easy
Carbon Dioxide (breathed out) [waste gas]	Anatomy - Easy
Vitamins (in healthy food) [body needs them]	Anatomy - Easy
Calcium (mineral for body) [strong bones]	Anatomy - Easy
Iron (mineral in blood) [carries oxygen]	Anatomy - Easy
Protein (in meat and beans) [builds muscle]	Anatomy - Easy
Carbohydrates (in bread and rice) [give energy]	Anatomy - Easy
Fats (in oils and butter) [store energy]	Anatomy - Easy
Fiber (in fruits and veggies) [aids digestion]	Anatomy - Easy
Water (essential drink) [hydrates the body]	Anatomy - Easy
Exercise (physical activity) [keeps body healthy]	Anatomy - Easy
Sleep (rest at night) [body repairs itself]	Anatomy - Easy
Pulse (felt at wrist) [heartbeat rate]	Anatomy - Easy
Temperature (body heat level) [98.6 degrees F]	Anatomy - Easy
Reflexes (automatic response) [involuntary movement]	Anatomy - Easy
Posture (how you stand) [body alignment]	Anatomy - Easy
Osteocyte (bone cell type) [mature bone cell]	Anatomy - Intermediate
Osteoblast (bone cell type) [builds new bone]	Anatomy - Intermediate
Osteoclast (bone cell type) [breaks down bone]	Anatomy - Intermediate
Periosteum (bone covering) [outer bone membrane]	Anatomy - Intermediate
Epiphysis (bone region) [end of long bone]	Anatomy - Intermediate
Diaphysis (bone region) [shaft of long bone]	Anatomy - Intermediate
Haversian Canal (compact bone) [blood vessel channel]	Anatomy - Intermediate
Ossification (bone formation) [cartilage becomes bone]	Anatomy - Intermediate
Synovial Joint (movable joint) [fluid-filled joint]	Anatomy - Intermediate
Ligament (connective tissue) [bone to bone]	Anatomy - Intermediate
Tendon (connective tissue) [muscle to bone]	Anatomy - Intermediate
Bursa (joint structure) [reduces friction]	Anatomy - Intermediate
Meniscus (knee cartilage) [shock absorber]	Anatomy - Intermediate
Intervertebral Disc (spine cushion) [between vertebrae]	Anatomy - Intermediate
Sarcomere (muscle unit) [contractile unit]	Anatomy - Intermediate
Myofibril (muscle fiber part) [contains sarcomeres]	Anatomy - Intermediate
Actin (muscle protein) [thin filament]	Anatomy - Intermediate
Myosin (muscle protein) [thick filament]	Anatomy - Intermediate
Neuromuscular Junction (nerve-muscle meeting) [signal transmission]	Anatomy - Intermediate
Skeletal Muscle (voluntary muscle) [moves skeleton]	Anatomy - Intermediate
Smooth Muscle (involuntary muscle) [lines organs]	Anatomy - Intermediate
Cardiac Muscle (heart muscle) [involuntary striated]	Anatomy - Intermediate
Fascia (connective tissue) [surrounds muscles]	Anatomy - Intermediate
Muscle Contraction (sliding filament) [shortens muscle]	Anatomy - Intermediate
Sinoatrial Node (heart pacemaker) [sets heart rate]	Anatomy - Intermediate
Atrioventricular Node (heart conduction) [delays signal]	Anatomy - Intermediate
Right Atrium (heart chamber) [receives deoxygenated blood]	Anatomy - Intermediate
Left Ventricle (heart chamber) [pumps to body]	Anatomy - Intermediate
Pulmonary Artery (heart vessel) [carries blood to lungs]	Anatomy - Intermediate
Pulmonary Vein (heart vessel) [returns oxygenated blood]	Anatomy - Intermediate
Aortic Valve (heart valve) [prevents backflow]	Anatomy - Intermediate
Systole (cardiac cycle) [heart contraction]	Anatomy - Intermediate
Diastole (cardiac cycle) [heart relaxation]	Anatomy - Intermediate
Blood Pressure (cardiovascular measure) [systolic over diastolic]	Anatomy - Intermediate
Hemoglobin (red blood cell protein) [carries oxygen]	Anatomy - Intermediate
Erythrocyte (blood cell type) [red blood cell]	Anatomy - Intermediate
Leukocyte (blood cell type) [white blood cell]	Anatomy - Intermediate
Thrombocyte (blood component) [platelet]	Anatomy - Intermediate
Alveoli (lung structures) [gas exchange]	Anatomy - Intermediate
Bronchioles (lung airways) [small air passages]	Anatomy - Intermediate
Pleura (lung membrane) [surrounds lungs]	Anatomy - Intermediate
Surfactant (lung substance) [reduces surface tension]	Anatomy - Intermediate
Diaphragm (respiratory muscle) [primary breathing muscle]	Anatomy - Intermediate
Tidal Volume (breathing measure) [normal breath volume]	Anatomy - Intermediate
Vital Capacity (lung measure) [maximum air exhaled]	Anatomy - Intermediate
Cerebral Cortex (brain surface) [higher thinking]	Anatomy - Intermediate
Frontal Lobe (brain region) [decision making]	Anatomy - Intermediate
Temporal Lobe (brain region) [hearing and memory]	Anatomy - Intermediate
Occipital Lobe (brain region) [visual processing]	Anatomy - Intermediate
Parietal Lobe (brain region) [sensory processing]	Anatomy - Intermediate
Hypothalamus (brain structure) [homeostasis control]	Anatomy - Intermediate
Thalamus (brain structure) [sensory relay station]	Anatomy - Intermediate
Medulla Oblongata (brainstem part) [vital functions]	Anatomy - Intermediate
Myelin Sheath (nerve covering) [speeds nerve signals]	Anatomy - Intermediate
Synapse (nerve gap) [neurotransmitter release]	Anatomy - Intermediate
Axon (neuron part) [carries signals away]	Anatomy - Intermediate
Dendrite (neuron part) [receives signals]	Anatomy - Intermediate
Neurotransmitter (chemical messenger) [crosses synapse]	Anatomy - Intermediate
Sympathetic Nervous System (autonomic division) [fight or flight]	Anatomy - Intermediate
Parasympathetic Nervous System (autonomic division) [rest and digest]	Anatomy - Intermediate
Thyroid Gland (endocrine gland) [metabolism regulation]	Anatomy - Intermediate
Adrenal Cortex (adrenal region) [cortisol production]	Anatomy - Intermediate
Adrenal Medulla (adrenal region) [epinephrine production]	Anatomy - Intermediate
Insulin (pancreatic hormone) [lowers blood sugar]	Anatomy - Intermediate
Glucagon (pancreatic hormone) [raises blood sugar]	Anatomy - Intermediate
Estrogen (sex hormone) [female development]	Anatomy - Intermediate
Testosterone (sex hormone) [male development]	Anatomy - Intermediate
Growth Hormone (pituitary hormone) [stimulates growth]	Anatomy - Intermediate
Thymus (lymphatic organ) [T cell maturation]	Anatomy - Intermediate
Lymph Nodes (lymphatic structures) [filter lymph fluid]	Anatomy - Intermediate
Spleen (lymphatic organ) [filters blood]	Anatomy - Intermediate
Lymphocyte (immune cell) [adaptive immunity]	Anatomy - Intermediate
Antibody (immune protein) [targets pathogens]	Anatomy - Intermediate
Antigen (foreign substance) [triggers immune response]	Anatomy - Intermediate
Nephron (kidney unit) [filters blood]	Anatomy - Intermediate
Glomerulus (kidney structure) [filtration unit]	Anatomy - Intermediate
Bowman's Capsule (kidney structure) [surrounds glomerulus]	Anatomy - Intermediate
Loop of Henle (nephron part) [concentrates urine]	Anatomy - Intermediate
Collecting Duct (kidney tube) [final urine processing]	Anatomy - Intermediate
Ovary (female organ) [produces eggs]	Anatomy - Intermediate
Testis (male organ) [produces sperm]	Anatomy - Intermediate
Uterus (female organ) [fetal development]	Anatomy - Intermediate
Fallopian Tube (female anatomy) [egg transport]	Anatomy - Intermediate
Zygote (fertilized egg) [first cell]	Anatomy - Intermediate
Epithelial Tissue (body tissue) [covers surfaces]	Anatomy - Intermediate
Connective Tissue (body tissue) [supports structures]	Anatomy - Intermediate
Nervous Tissue (body tissue) [transmits impulses]	Anatomy - Intermediate
Muscle Tissue (body tissue) [produces movement]	Anatomy - Intermediate
Homeostasis (body regulation) [internal balance]	Anatomy - Intermediate
Mitosis (cell division) [identical daughter cells]	Anatomy - Intermediate
Meiosis (cell division) [gamete production]	Anatomy - Intermediate
ATP (energy molecule) [cellular energy currency]	Anatomy - Intermediate
Cellular Respiration (energy process) [glucose to ATP]	Anatomy - Intermediate
Osmosis (water movement) [across membrane]	Anatomy - Intermediate
Diffusion (particle movement) [high to low concentration]	Anatomy - Intermediate
pH Balance (body chemistry) [acid-base balance]	Anatomy - Intermediate
Enzymes (biological catalysts) [speed up reactions]	Anatomy - Intermediate
Metabolism (body processes) [chemical reactions in body]	Anatomy - Intermediate
Anatomical Position (body reference) [standard body position]	Anatomy - Intermediate
Anterior and Posterior (directional terms) [front and back]	Anatomy - Intermediate
Pharaoh (Egyptian ruler) [king of Egypt]	World History - Easy
Pyramids (Egyptian structures) [tombs for pharaohs]	World History - Easy
Sphinx (Egyptian monument) [lion with human head]	World History - Easy
Hieroglyphics (Egyptian writing) [picture symbols]	World History - Easy
Mummies (preserved bodies) [ancient Egyptian burial]	World History - Easy
Cleopatra (Egyptian queen) [last pharaoh]	World History - Easy
King Tut (boy pharaoh) [Tutankhamun]	World History - Easy
Nile River (Egyptian river) [longest river in Africa]	World History - Easy
Zeus (Greek mythology) [king of the gods]	World History - Easy
Athena (Greek goddess) [goddess of wisdom]	World History - Easy
Poseidon (Greek god) [god of the sea]	World History - Easy
Hercules (Greek hero) [son of Zeus]	World History - Easy
Olympics (ancient Greece) [athletic competition]	World History - Easy
Parthenon (Greek building) [temple to Athena]	World History - Easy
Democracy (Greek invention) [rule by the people]	World History - Easy
Socrates (Greek thinker) [famous philosopher]	World History - Easy
Alexander the Great (Greek king) [conquered vast empire]	World History - Easy
Trojan Horse (Greek legend) [hidden soldiers inside]	World History - Easy
Colosseum (Roman arena) [gladiator fights]	World History - Easy
Julius Caesar (Roman leader) [assassinated ruler]	World History - Easy
Roman Empire (ancient civilization) [ruled Mediterranean]	World History - Easy
Gladiators (Roman fighters) [arena warriors]	World History - Easy
Aqueducts (Roman invention) [carried water]	World History - Easy
Roman Roads (ancient highways) [connected the empire]	World History - Easy
Augustus (first emperor) [Roman Empire founder]	World History - Easy
Pompeii (Roman city) [buried by volcano]	World History - Easy
Great Wall (Chinese structure) [defense wall]	World History - Easy
Silk Road (ancient trade route) [connected East and West]	World History - Easy
Confucius (Chinese philosopher) [teachings on morality]	World History - Easy
Terracotta Army (Chinese tomb) [clay soldiers]	World History - Easy
Samurai (Japanese warriors) [feudal fighters]	World History - Easy
Vikings (Norse explorers) [Scandinavian raiders]	World History - Easy
Marco Polo (Italian explorer) [traveled to China]	World History - Easy
Christopher Columbus (explorer) [reached the Americas]	World History - Easy
Ferdinand Magellan (explorer) [first circumnavigation]	World History - Easy
Vasco da Gama (Portuguese explorer) [sailed to India]	World History - Easy
Leif Erikson (Norse explorer) [reached North America]	World History - Easy
Compass (navigation tool) [points north]	World History - Easy
Printing Press (Gutenberg invention) [mass-produced books]	World History - Easy
Wheel (ancient invention) [transportation tool]	World History - Easy
Paper (Chinese invention) [writing material]	World History - Easy
Gunpowder (Chinese invention) [explosive powder]	World History - Easy
Telescope (Galileo's tool) [see distant objects]	World History - Easy
Steam Engine (industrial invention) [powered by steam]	World History - Easy
Electricity (modern discovery) [powers devices]	World History - Easy
Telephone (Bell's invention) [voice communication]	World History - Easy
Light Bulb (Edison's invention) [artificial light]	World History - Easy
Airplane (Wright Brothers) [powered flight]	World History - Easy
Gandhi (Indian leader) [nonviolent independence]	World History - Easy
Nelson Mandela (South African leader) [ended apartheid]	World History - Easy
Queen Victoria (British monarch) [Victorian Era]	World History - Easy
Napoleon (French emperor) [conquered Europe]	World History - Easy
Winston Churchill (British PM) [WWII leader]	World History - Easy
Genghis Khan (Mongol leader) [largest land empire]	World History - Easy
Africa (continent) [second largest continent]	World History - Easy
Asia (continent) [largest continent]	World History - Easy
Europe (continent) [western part of Eurasia]	World History - Easy
South America (continent) [Amazon Rainforest]	World History - Easy
Antarctica (continent) [coldest continent]	World History - Easy
Australia (continent) [smallest continent]	World History - Easy
North America (continent) [third largest continent]	World History - Easy
Christianity (world religion) [follows Jesus Christ]	World History - Easy
Islam (world religion) [follows Muhammad]	World History - Easy
Buddhism (world religion) [founded by Buddha]	World History - Easy
Hinduism (world religion) [oldest major religion]	World History - Easy
Judaism (world religion) [Torah is holy book]	World History - Easy
Great Pyramid of Giza (ancient wonder) [oldest wonder]	World History - Easy
Hanging Gardens (ancient wonder) [Babylon gardens]	World History - Easy
Lighthouse of Alexandria (ancient wonder) [guided ships]	World History - Easy
Colossus of Rhodes (ancient wonder) [giant statue]	World History - Easy
Eiffel Tower (Paris landmark) [iron tower]	World History - Easy
Taj Mahal (Indian landmark) [marble mausoleum]	World History - Easy
Big Ben (London landmark) [clock tower]	World History - Easy
Great Barrier Reef (Australian landmark) [coral reef]	World History - Easy
Machu Picchu (Inca ruins) [mountain citadel]	World History - Easy
Stonehenge (English monument) [stone circle]	World History - Easy
Chichen Itza (Mayan ruins) [pyramid temple]	World History - Easy
Easter Island (Pacific island) [stone head statues]	World History - Easy
Chinese New Year (Asian holiday) [lunar new year]	World History - Easy
Diwali (Hindu festival) [festival of lights]	World History - Easy
Day of the Dead (Mexican tradition) [honor deceased]	World History - Easy
Carnival (Brazilian celebration) [pre-Lent festival]	World History - Easy
Kimono (Japanese clothing) [traditional robe]	World History - Easy
Sari (Indian clothing) [draped garment]	World History - Easy
Boomerang (Australian tool) [returning throw stick]	World History - Easy
Totem Pole (Native American art) [carved wooden pole]	World History - Easy
Mesopotamia (ancient region) [cradle of civilization]	World History - Easy
Hammurabi (Babylonian king) [first written laws]	World History - Easy
Rosetta Stone (Egyptian artifact) [decoded hieroglyphics]	World History - Easy
Iron Age (historical period) [iron tools era]	World History - Easy
Bronze Age (historical period) [bronze tools era]	World History - Easy
Stone Age (earliest period) [stone tools era]	World History - Easy
Feudalism (medieval system) [lords and serfs]	World History - Easy
Castles (medieval structures) [fortified homes]	World History - Easy
Knights (medieval warriors) [armored fighters]	World History - Easy
Crusades (medieval wars) [religious wars]	World History - Easy
Black Death (medieval plague) [killed millions]	World History - Easy
Renaissance (cultural rebirth) [art and learning]	World History - Easy
Leonardo da Vinci (Renaissance artist) [Mona Lisa painter]	World History - Easy
Michelangelo (Renaissance artist) [Sistine Chapel]	World History - Easy
Renaissance (14th-17th century) [cultural rebirth]	World History - Intermediate
Humanism (Renaissance philosophy) [focus on humans]	World History - Intermediate
Niccolo Machiavelli (political thinker) [The Prince]	World History - Intermediate
Medici Family (Florence rulers) [Renaissance patrons]	World History - Intermediate
Gutenberg Bible (first printed book) [movable type]	World History - Intermediate
Protestant Reformation (religious movement) [split from Catholic]	World History - Intermediate
Martin Luther (German reformer) [95 Theses]	World History - Intermediate
John Calvin (religious reformer) [predestination]	World History - Intermediate
Henry VIII (English king) [broke with Rome]	World History - Intermediate
Counter-Reformation (Catholic response) [Council of Trent]	World History - Intermediate
Jesuits (Catholic order) [Society of Jesus]	World History - Intermediate
Inquisition (Church tribunal) [punish heresy]	World History - Intermediate
Treaty of Tordesillas (1494 agreement) [divided new world]	World History - Intermediate
Hernan Cortes (Spanish conquistador) [conquered Aztecs]	World History - Intermediate
Francisco Pizarro (Spanish conquistador) [conquered Incas]	World History - Intermediate
Columbian Exchange (global transfer) [crops and diseases]	World History - Intermediate
Triangular Trade (Atlantic commerce) [slaves goods raw materials]	World History - Intermediate
Middle Passage (slave trade route) [Africa to Americas]	World History - Intermediate
Mercantilism (economic system) [export more than import]	World History - Intermediate
East India Company (trading company) [colonial trade monopoly]	World History - Intermediate
Scramble for Africa (1880s-1900s) [European colonization]	World History - Intermediate
Berlin Conference (1884 meeting) [divided Africa]	World History - Intermediate
Opium Wars (China vs Britain) [forced open trade]	World History - Intermediate
Meiji Restoration (Japanese reform) [modernized Japan]	World History - Intermediate
French Revolution (1789 uprising) [overthrew monarchy]	World History - Intermediate
Bastille (French prison) [stormed by revolutionaries]	World History - Intermediate
Reign of Terror (French Revolution) [mass executions]	World History - Intermediate
Robespierre (French revolutionary) [led the Terror]	World History - Intermediate
Declaration of Rights of Man (French document) [natural rights]	World History - Intermediate
Napoleon Bonaparte (French emperor) [conquered Europe]	World History - Intermediate
Napoleonic Code (legal system) [civil law reform]	World History - Intermediate
Congress of Vienna (1815 meeting) [restored balance of power]	World History - Intermediate
Haitian Revolution (slave revolt) [first Black republic]	World History - Intermediate
Simon Bolivar (South American liberator) [freed colonies]	World History - Intermediate
Industrial Revolution (economic transformation) [factory production]	World History - Intermediate
Adam Smith (economist) [Wealth of Nations]	World History - Intermediate
Karl Marx (political theorist) [Communist Manifesto]	World History - Intermediate
Capitalism (economic system) [private ownership]	World History - Intermediate
Socialism (economic system) [shared ownership]	World History - Intermediate
Communism (political ideology) [classless society]	World History - Intermediate
Luddites (British protesters) [opposed machinery]	World History - Intermediate
Child Labor (industrial problem) [factory children]	World History - Intermediate
Labor Unions (worker organizations) [collective bargaining]	World History - Intermediate
Suffragette Movement (women's rights) [right to vote]	World History - Intermediate
Archduke Franz Ferdinand (assassination victim) [sparked WWI]	World History - Intermediate
Triple Alliance (WWI alliance) [Germany Austria Italy]	World History - Intermediate
Triple Entente (WWI alliance) [Britain France Russia]	World History - Intermediate
Trench Warfare (WWI combat) [static front lines]	World History - Intermediate
Mustard Gas (WWI weapon) [chemical warfare]	World History - Intermediate
Armistice (end of WWI) [November 11 1918]	World History - Intermediate
Treaty of Versailles (post-WWI treaty) [punished Germany]	World History - Intermediate
League of Nations (post-WWI organization) [collective security]	World History - Intermediate
Weimar Republic (German government) [post-WWI Germany]	World History - Intermediate
Adolf Hitler (Nazi leader) [started WWII]	World History - Intermediate
Fascism (political ideology) [authoritarian nationalism]	World History - Intermediate
Appeasement (pre-WWII policy) [concessions to Hitler]	World History - Intermediate
Blitzkrieg (German tactic) [lightning war]	World History - Intermediate
Holocaust (Nazi genocide) [six million Jews killed]	World History - Intermediate
D-Day Invasion (June 6 1944) [Normandy landings]	World History - Intermediate
Atomic Bombings (end of WWII) [Hiroshima and Nagasaki]	World History - Intermediate
United Nations (post-WWII organization) [international cooperation]	World History - Intermediate
Universal Declaration (1948 document) [human rights]	World History - Intermediate
Nuremberg Trials (post-WWII courts) [prosecuted war crimes]	World History - Intermediate
Iron Curtain (Cold War division) [East-West divide]	World History - Intermediate
Berlin Wall (Cold War symbol) [divided Berlin]	World History - Intermediate
Cuban Missile Crisis (1962 standoff) [nuclear threat]	World History - Intermediate
Space Race (Cold War competition) [US vs Soviet space]	World History - Intermediate
Proxy Wars (Cold War conflicts) [indirect superpower wars]	World History - Intermediate
Korean War (Cold War conflict) [divided Korea]	World History - Intermediate
Vietnam War (Cold War conflict) [US vs North Vietnam]	World History - Intermediate
Detente (Cold War relaxation) [reduced tensions]	World History - Intermediate
Glasnost (Soviet reform) [openness policy]	World History - Intermediate
Perestroika (Soviet reform) [economic restructuring]	World History - Intermediate
Fall of USSR (1991 event) [end of Soviet Union]	World History - Intermediate
Indian Independence (1947 event) [British withdrawal]	World History - Intermediate
Partition of India (1947 division) [India and Pakistan]	World History - Intermediate
Apartheid (South African policy) [racial segregation]	World History - Intermediate
Rwandan Genocide (1994 tragedy) [ethnic mass killing]	World History - Intermediate
Tiananmen Square (1989 protest) [Chinese democracy movement]	World History - Intermediate
Arab Spring (2010s uprisings) [Middle East protests]	World History - Intermediate
European Union (political union) [European integration]	World History - Intermediate
Bretton Woods (1944 conference) [global financial system]	World History - Intermediate
World Trade Organization (trade body) [regulates global trade]	World History - Intermediate
Geneva Conventions (humanitarian laws) [rules of war]	World History - Intermediate
Marshall Plan (post-WWII aid) [rebuilt Europe]	World History - Intermediate
NATO (military alliance) [Western defense pact]	World History - Intermediate
Warsaw Pact (military alliance) [Soviet defense bloc]	World History - Intermediate
Camp David Accords (1978 agreement) [Egypt-Israel peace]	World History - Intermediate
Oslo Accords (1993 agreement) [Israeli-Palestinian peace]	World History - Intermediate
Good Friday Agreement (1998 deal) [Northern Ireland peace]	World History - Intermediate
Balfour Declaration (1917 statement) [Jewish homeland]	World History - Intermediate
Sykes-Picot Agreement (1916 deal) [divided Middle East]	World History - Intermediate
Treaty of Nanking (1842 treaty) [ended First Opium War]	World History - Intermediate
Magna Carta (1215 document) [limited king's power]	World History - Intermediate
English Bill of Rights (1689 law) [parliamentary power]	World History - Intermediate
Enlightenment (intellectual movement) [reason over tradition]	World History - Intermediate
John Locke (Enlightenment thinker) [natural rights]	World History - Intermediate
Voltaire (French philosopher) [freedom of speech]	World History - Intermediate
Jean-Jacques Rousseau (philosopher) [social contract]	World History - Intermediate
Decolonization (post-WWII process) [colonies gain freedom]	World History - Intermediate
